Player,Country,Start,End,Matches,Innings,Dismissals,Caught,CaughtFielder,CaughtBehind,Stumped,MaxDismissalsInnings
KC Sangakkara (Asia/ICC/SL),NA,2000,2015,404,397,501,402,19,383,99,5
AC Gilchrist (AUS/ICC),NA,1996,2008,287,286,472,417,0,417,55,6
MS Dhoni (Asia/IND),NA,2004,2019,350,345,444,321,0,321,123,6
MV Boucher (Afr/SA),NA,1998,2011,295,291,425,403,1,402,22,6
Mushfiqur Rahim ,BAN,2006,2024,272,270,298,242,2,240,56,5
Moin Khan ,Pakistan,1990,2004,219,217,287,214,0,214,73,5
BB McCullum ,New Zealand,2002,2016,260,257,277,262,35,227,15,5
JC Buttler ,England,2012,2023,181,177,258,221,0,221,37,6
IA Healy ,Australia,1988,1997,168,168,233,194,0,194,39,4
Q de Kock ,South Africa,2013,2023,155,149,226,209,0,209,17,6
Rashid Latif ,Pakistan,1992,2003,166,164,220,182,0,182,38,5
DPMD Jayawardene (Asia/SL),NA,1998,2015,448,443,218,218,218,0,0,4
R Dravid (Asia/ICC/IND),NA,1996,2011,344,341,210,196,124,72,14,4
RS Kaluwitharana ,Sri Lanka,1990,2004,189,188,207,132,1,131,75,5
PJL Dujon ,West Indies,1981,1991,169,168,204,183,0,183,21,4
RD Jacobs ,West Indies,1996,2004,147,145,189,160,0,160,29,6
Kamran Akmal ,Pakistan,2002,2017,157,154,188,157,1,156,31,5
D Ramdin ,West Indies,2005,2016,139,137,188,181,0,181,7,5
AB de Villiers (Afr/SA),NA,2005,2018,228,223,181,176,83,93,5,5
BJ Haddin ,Australia,2001,2015,126,124,181,170,0,170,11,5
AJ Stewart ,England,1989,2003,170,169,174,159,11,148,15,6
A Flower ,Zimbabwe,1992,2003,213,212,173,141,8,133,32,5
DJ Richardson ,South Africa,1991,1998,122,121,165,148,0,148,17,5
BRM Taylor ,Zimbabwe,2004,2021,205,205,162,133,31,102,29,5
RT Ponting (AUS/ICC),NA,1995,2012,375,372,160,160,160,0,0,3
M Azharuddin ,India,1985,2000,334,332,156,156,156,0,0,4
NR Mongia ,India,1994,2000,140,139,154,110,0,110,44,5
V Kohli ,India,2008,2024,295,292,152,152,152,0,0,3
SD Hope ,West Indies,2016,2024,130,127,148,135,0,135,13,5
T Taibu (Afr/ZIM),NA,2001,2012,150,150,147,114,2,112,33,4
Sarfaraz Ahmed ,Pakistan,2007,2021,117,115,143,119,0,119,24,6
LRPL Taylor ,New Zealand,2006,2022,236,232,142,142,142,0,0,4
AC Parore ,New Zealand,1992,2002,179,178,141,116,5,111,25,5
TWM Latham ,New Zealand,2012,2023,147,145,140,125,31,94,15,5
SR Tendulkar ,India,1989,2012,463,456,140,140,140,0,0,4
Younis Khan ,Pakistan,2000,2015,265,260,135,135,130,5,0,4
MH Cross ,Scotland,2014,2024,101,99,134,125,0,125,9,6
SP Fleming (ICC/NZ),NA,1994,2007,280,276,133,133,133,0,0,4
JH Kallis (Afr/ICC/SA),NA,1996,2014,328,324,131,131,131,0,0,3
M Muralidaran (Asia/ICC/SL),NA,1993,2011,350,347,130,130,130,0,0,3
AR Border ,Australia,1979,1994,273,270,127,127,127,0,0,3
Shahid Afridi (Asia/ICC/PAK),NA,1996,2015,398,392,127,127,127,0,0,2
Khaled Mashud ,BAN,1995,2006,126,126,126,91,0,91,35,5
TM Dilshan ,Sri Lanka,1999,2016,330,325,124,123,118,5,1,3
CH Gayle (ICC/WI),NA,1999,2019,301,294,124,124,124,0,0,3
RW Marsh ,Australia,1971,1984,92,92,124,120,0,120,4,5
ST Jayasuriya (Asia/SL),NA,1989,2011,445,441,123,123,123,0,0,3
CL Hooper ,West Indies,1987,2003,227,225,120,120,120,0,0,4
BC Lara (ICC/WI),NA,1990,2007,299,296,120,120,120,0,0,3
L Ronchi (AUS/NZ),NA,2008,2017,85,83,117,105,0,105,12,4
MS Wade ,Australia,2012,2021,97,97,117,108,0,108,9,5
Inzamam-ul-Haq (Asia/PAK),NA,1991,2007,378,373,113,113,113,0,0,3
SR Waugh ,Australia,1986,2002,325,324,111,111,111,0,0,3
RS Mahanama ,Sri Lanka,1986,1999,213,212,109,109,109,0,0,3
PD Collingwood ,England,2001,2011,197,197,108,108,108,0,0,3
HH Gibbs ,South Africa,1996,2010,248,246,108,108,108,0,0,3
SM Pollock (Afr/ICC/SA),NA,1996,2008,303,300,108,108,108,0,0,2
ME Waugh ,Australia,1988,2002,244,243,108,108,108,0,0,3
MJ Clarke ,Australia,2003,2015,245,243,106,106,106,0,0,4
MEK Hussey ,Australia,2004,2012,185,184,105,105,105,0,0,3
BKG Mendis ,Sri Lanka,2016,2024,138,137,105,93,39,54,12,3
JN Rhodes ,South Africa,1992,2003,245,242,105,105,105,0,0,5
GC Smith (Afr/SA),NA,2002,2013,197,196,105,105,105,0,0,4
MJ Guptill ,New Zealand,2009,2022,198,196,104,104,104,0,0,4
NJ O'Brien ,Ireland,2006,2018,103,99,104,90,8,82,14,5
Saleem Yousuf ,Pakistan,1982,1990,86,86,103,81,0,81,22,4
SK Raina ,India,2005,2018,226,223,102,102,102,0,0,3
SC Ganguly (Asia/IND),NA,1992,2007,311,309,100,100,100,0,0,3
IVA Richards ,West Indies,1975,1991,187,186,100,100,100,0,0,3
Shoaib Malik ,Pakistan,1999,2019,287,285,98,98,98,0,0,2
CZ Harris ,New Zealand,1990,2004,250,247,96,96,96,0,0,4
PA de Silva ,Sri Lanka,1984,2003,308,307,95,95,95,0,0,3
RG Sharma ,India,2007,2024,265,263,95,95,95,0,0,3
HP Tillakaratne ,Sri Lanka,1986,2003,200,199,95,89,50,39,6,5
Yuvraj Singh (Asia/IND),NA,2000,2017,304,298,94,94,94,0,0,3
V Sehwag (Asia/ICC/IND),NA,1999,2013,251,246,93,93,93,0,0,3
AT Carey ,Australia,2018,2024,76,76,92,84,0,84,8,5
Ijaz Ahmed ,Pakistan,1986,2000,250,249,90,90,90,0,0,3
KS More ,India,1984,1993,94,93,90,63,0,63,27,5
Umar Akmal ,Pakistan,2009,2019,121,119,90,77,32,45,13,5
GJ Maxwell ,Australia,2012,2024,145,145,89,89,89,0,0,4
Mohammad Rizwan ,Pakistan,2015,2024,77,77,89,86,12,74,3,6
Mohammad Shahzad ,Afghanistan,2009,2019,84,83,89,64,1,63,25,5
DL Vettori (ICC/NZ),NA,1997,2015,295,289,88,88,88,0,0,2
Wasim Akram ,Pakistan,1984,2003,356,352,88,88,88,0,0,3
HM Amla ,South Africa,2008,2019,181,176,87,87,87,0,0,4
EJG Morgan (ENG/IRE),NA,2006,2022,248,242,87,87,84,3,0,3
GW Flower ,Zimbabwe,1992,2010,221,220,86,86,86,0,0,2
IDS Smith ,New Zealand,1980,1992,98,97,86,81,1,80,5,3
SPD Smith ,Australia,2010,2024,165,165,86,86,86,0,0,3
A Kumble (Asia/IND),NA,1990,2007,271,268,85,85,85,0,0,2
Mohammad Hafeez ,Pakistan,2003,2019,218,216,85,85,85,0,0,2
JE Root ,England,2013,2023,171,167,85,85,85,0,0,4
NJ Astle ,New Zealand,1995,2007,223,219,83,83,83,0,0,3
S Dhawan ,India,2010,2022,167,164,83,83,83,0,0,4
DA Miller ,South Africa,2010,2023,173,168,83,83,83,0,0,3
GC Wilson ,Ireland,2007,2019,105,101,83,73,24,49,10,4
JP Duminy ,South Africa,2004,2019,199,195,82,82,82,0,0,3
Mahmudullah ,BAN,2007,2024,235,234,82,82,82,0,0,3
A Symonds ,Australia,1998,2009,198,196,82,82,82,0,0,4
F du Plessis ,South Africa,2011,2019,143,141,81,81,81,0,0,3
Saleem Malik ,Pakistan,1982,1999,283,277,81,81,80,1,0,4
SK Warne (AUS/ICC),NA,1993,2005,194,193,80,80,80,0,0,3
UDU Chandana ,Sri Lanka,1994,2007,147,146,79,79,79,0,0,3
MJ Prior ,England,2004,2011,68,68,79,71,2,69,8,6
Mohammad Nabi ,Afghanistan,2009,2024,167,164,77,77,77,0,0,3
ADR Campbell ,Zimbabwe,1992,2003,188,187,76,76,74,2,0,3
RB Richardson ,West Indies,1983,1996,224,222,75,75,75,0,0,4
RA Jadeja ,India,2009,2023,197,195,74,74,74,0,0,3
JC Adams ,West Indies,1992,2001,127,127,73,68,42,26,5,5
DJ Bravo ,West Indies,2004,2014,164,161,73,73,73,0,0,3
S Chanderpaul ,West Indies,1994,2011,268,264,73,73,73,0,0,2
WJ Cronje ,South Africa,1992,2000,188,186,73,73,73,0,0,2
Javed Miandad ,Pakistan,1975,1996,233,229,73,71,70,1,2,3
SB Styris ,New Zealand,1999,2011,188,185,73,73,73,0,0,3
E Chigumbura (Afr/ZIM),NA,2004,2018,213,212,72,72,72,0,0,4
GO Jones (ENG/PNG),NA,2004,2014,51,51,72,68,0,68,4,5
AJ Finch ,Australia,2013,2022,146,146,71,71,71,0,0,3
Harbhajan Singh (Asia/IND),NA,1998,2015,236,231,71,71,71,0,0,3
N Kapil Dev ,India,1978,1994,225,222,71,71,71,0,0,3
KD Karthik ,India,2004,2019,94,94,71,64,29,35,7,4
H Masakadza ,Zimbabwe,2001,2019,209,209,71,71,71,0,0,2
LJ Tucker ,Ireland,2019,2024,52,50,71,68,1,67,3,4
DA Warner ,Australia,2009,2023,161,161,71,71,71,0,0,2
MS Atapattu ,Sri Lanka,1990,2007,268,266,70,70,70,0,0,3
LD Chandimal ,Sri Lanka,2010,2022,157,154,70,62,29,33,8,4
MG Bevan ,Australia,1994,2004,232,230,69,69,69,0,0,3
SA Edwards ,NED,2018,2024,59,59,69,57,0,57,12,5
DR Martyn ,Australia,1992,2006,208,205,69,69,69,0,0,3
A Bagai ,Canada,2003,2013,62,62,68,59,1,58,9,4
CO Browne ,West Indies,1995,2005,46,46,68,59,0,59,9,5
ML Hayden (AUS/ICC),NA,1993,2008,161,158,68,68,68,0,0,2
WTS Porterfield ,Ireland,2006,2022,148,141,68,68,68,0,0,3
KL Rahul ,India,2016,2024,77,77,68,63,11,52,5,4
Tamim Iqbal ,BAN,2007,2023,243,241,68,68,68,0,0,3
KJ O'Brien ,Ireland,2006,2021,153,149,67,67,67,0,0,3
DJG Sammy ,West Indies,2004,2015,126,124,67,67,67,0,0,3
SO Tikolo (Afr/KENYA),NA,1996,2014,135,135,67,67,67,0,0,3
CL Cairns (ICC/NZ),NA,1991,2006,215,214,66,66,66,0,0,3
MD Crowe ,New Zealand,1982,1995,143,141,66,66,66,0,0,3
Misbah-ul-Haq ,Pakistan,2002,2015,162,160,66,66,66,0,0,4
KS Williamson ,New Zealand,2010,2023,165,164,66,66,66,0,0,3
JO Holder ,West Indies,2013,2023,138,135,65,65,65,0,0,2
C Kieswetter ,England,2010,2013,46,45,65,53,1,52,12,5
GA Hick ,England,1991,2001,120,119,64,64,64,0,0,3
KA Pollard ,West Indies,2007,2022,123,121,64,64,64,0,0,4
SR Watson ,Australia,2002,2015,190,189,64,64,64,0,0,2
A Ranatunga ,Sri Lanka,1982,1999,269,268,63,63,63,0,0,3
DJ Cullinan ,South Africa,1993,2000,138,135,62,62,62,0,0,3
G Kirsten ,South Africa,1993,2003,185,183,62,61,60,1,1,3
Litton Das ,BAN,2015,2024,91,90,62,58,45,13,4,4
Mashrafe Mortaza (Asia/BAN),NA,2001,2020,220,220,62,62,62,0,0,2
NLTC Perera ,Sri Lanka,2009,2021,166,162,62,62,62,0,0,2
Wasim Bari ,Pakistan,1973,1984,51,50,62,52,0,52,10,4
AL Logie ,West Indies,1981,1993,158,158,61,61,61,0,0,3
PR Stirling ,Ireland,2008,2024,164,158,61,61,61,0,0,3
Shakib Al Hasan ,BAN,2006,2023,247,245,60,60,60,0,0,3
WPUJC Vaas (Asia/SL),NA,1994,2008,322,320,60,60,60,0,0,2
DL Haynes ,West Indies,1978,1994,238,236,59,59,59,0,0,2
A Jadeja ,India,1992,2000,196,195,59,59,59,0,0,2
JM Bairstow ,England,2011,2023,107,104,58,55,33,22,3,4
RW Chakabva ,Zimbabwe,2008,2022,61,61,58,53,12,41,5,5
Mohammad Yousuf (Asia/PAK),NA,1998,2010,288,285,58,58,58,0,0,2
MA Ouma ,Kenya,2004,2014,80,80,58,48,5,43,10,5
SC Williams ,Zimbabwe,2005,2023,156,155,58,58,58,0,0,3
KO Otieno ,Kenya,1996,2009,90,90,57,43,3,40,14,4
Sikandar Raza ,Zimbabwe,2013,2024,142,139,57,57,57,0,0,3
AJ Strauss ,England,2003,2011,127,127,57,57,57,0,0,3
CR Ervine ,Zimbabwe,2010,2024,119,117,56,56,56,0,0,4
MA Taylor ,Australia,1989,1997,113,113,56,56,56,0,0,4
RA Harper ,West Indies,1983,1996,105,105,55,55,55,0,0,3
M Kaif ,India,2002,2006,125,122,55,55,55,0,0,4
TD Paine ,Australia,2009,2018,35,34,55,51,0,51,4,5
PV Simmons ,West Indies,1987,1999,143,143,55,55,55,0,0,4
BA Stokes ,England,2011,2023,114,111,55,55,55,0,0,3
IR Bell ,England,2004,2015,161,160,54,54,54,0,0,3
DM Jones ,Australia,1984,1994,164,164,54,54,54,0,0,2
B Lee ,Australia,2000,2012,221,217,54,54,54,0,0,3
JM Anderson ,England,2002,2015,194,192,53,53,53,0,0,3
CS MacLeod ,Scotland,2008,2022,88,86,53,53,53,0,0,4
AD Mathews ,Sri Lanka,2008,2023,226,222,53,53,53,0,0,3
JR Murray ,West Indies,1992,1999,55,55,53,46,2,44,7,3
MDKJ Perera ,Sri Lanka,2013,2023,116,114,53,50,20,30,3,4
AB Agarkar ,India,1998,2007,191,188,52,52,52,0,0,2
N Dickwella ,Sri Lanka,2014,2022,55,55,52,41,0,41,11,4
H Klaasen ,South Africa,2018,2023,54,53,52,46,16,30,6,4
Babar Azam ,Pakistan,2015,2024,120,119,51,51,51,0,0,2
CS Baugh ,West Indies,2003,2012,47,46,51,39,0,39,12,4
JDP Oram ,New Zealand,2001,2012,160,159,51,51,51,0,0,2
JG Wright ,New Zealand,1978,1992,149,147,51,51,51,0,0,2
MN Samuels ,West Indies,2000,2018,207,207,50,50,50,0,0,2
WU Tharanga (Asia/SL),NA,2005,2019,235,228,50,50,50,0,0,3
P Utseya ,Zimbabwe,2004,2015,164,164,50,50,50,0,0,2
CR Woakes ,England,2011,2023,122,118,50,50,50,0,0,4
Aamer Sohail ,Pakistan,1990,2000,156,154,49,49,49,0,0,2
AP Gurusinha ,Sri Lanka,1985,1996,147,147,49,49,47,2,0,2
WB Phillips ,Australia,1982,1986,48,48,49,42,0,42,7,4
ME Trescothick ,England,2000,2006,123,121,49,49,45,4,0,3
KC Wessels (AUS/SA),NA,1983,1994,109,106,49,49,49,0,0,4
MM Ali ,England,2014,2023,138,135,48,48,48,0,0,3
RP Arnold ,Sri Lanka,1997,2007,180,179,48,48,48,0,0,2
GJ Bailey ,Australia,2012,2016,90,90,48,48,48,0,0,3
AM Rahane ,India,2011,2018,90,87,48,48,48,0,0,2
J Smits ,NED,2003,2009,38,38,48,41,0,41,7,4
GH Dockrell ,Ireland,2010,2024,127,123,47,47,47,0,0,3
A Flintoff (ENG/ICC),NA,1999,2009,141,140,47,47,47,0,0,3
ZE Green ,Namibia,2019,2024,40,40,47,41,0,41,6,5
RC Russell ,England,1987,1998,40,40,47,41,0,41,6,3
V Aravind ,United Arab Emirates,2019,2024,61,61,46,37,4,33,9,4
KMDN Kulasekara ,Sri Lanka,2003,2017,184,181,46,46,46,0,0,3
JJ Roy ,England,2015,2023,116,114,46,46,46,0,0,2
MA Starc ,Australia,2010,2024,127,127,46,46,46,0,0,3
HH Streak (Afr/ZIM),NA,1993,2005,189,188,46,46,46,0,0,2
CEL Ambrose ,West Indies,1988,2000,176,175,45,45,45,0,0,3
DC Boon ,Australia,1984,1995,181,181,45,45,45,0,0,2
GA Gooch ,England,1976,1995,125,125,45,45,45,0,0,2
CG Greenidge ,West Indies,1975,1991,128,127,45,45,45,0,0,2
AU Rashid ,England,2009,2024,143,140,45,45,45,0,0,3
RR Sarwan ,West Indies,2000,2013,181,176,45,45,45,0,0,2
D Williams ,West Indies,1988,1997,36,35,45,35,0,35,10,4
RD Berrington ,Scotland,2008,2024,123,121,44,44,44,0,0,2
DI Gower ,England,1978,1991,114,114,44,44,44,0,0,3
NV Knight ,England,1996,2003,100,100,44,44,44,0,0,2
CD McMillan ,New Zealand,1997,2007,197,193,44,44,44,0,0,2
DO Obuya ,Kenya,2001,2012,74,74,44,39,16,23,5,4
TG Southee ,New Zealand,2008,2023,161,160,44,44,44,0,0,3
Aasif Sheikh ,NEP,2021,2024,56,55,43,38,8,30,5,4
TA Boult ,New Zealand,2012,2023,114,113,43,43,43,0,0,2
Z Khan (Asia/IND),NA,2000,2012,200,197,43,43,43,0,0,3
CO Obuya ,Kenya,2001,2014,104,104,43,43,43,0,0,3
RL Powell ,West Indies,1999,2005,109,107,43,43,43,0,0,3
CMW Read ,England,2000,2006,36,35,43,41,0,41,2,5
MJ Santner ,New Zealand,2015,2024,107,105,43,43,43,0,0,2
Fakhar Zaman ,Pakistan,2017,2023,82,81,42,42,42,0,0,2
BM McMillan ,South Africa,1991,1998,78,77,42,42,42,0,0,3
KD Mills ,New Zealand,2001,2015,170,169,42,42,42,0,0,3
Saeed Anwar ,Pakistan,1989,2003,247,242,42,42,42,0,0,3
V Sibanda (Afr/ZIM),NA,2003,2016,127,127,42,42,42,0,0,2
K Srikkanth ,India,1981,1992,146,145,42,42,42,0,0,2
GP Thorpe ,England,1993,2002,82,81,42,42,42,0,0,3
DM de Silva ,Sri Lanka,2016,2023,90,89,41,41,41,0,0,3
NL McCullum ,New Zealand,2009,2015,84,83,41,41,41,0,0,4
KR Rutherford ,New Zealand,1985,1995,121,121,41,41,41,0,0,4
L Vincent ,New Zealand,2001,2007,102,100,41,41,39,2,0,2
A Balbirnie ,Ireland,2010,2024,111,107,40,40,40,0,0,4
K Bhurtel ,NEP,2021,2024,57,56,40,40,40,0,0,4
JV Coney ,New Zealand,1979,1987,88,86,40,40,40,0,0,3
N Hussain ,England,1989,2003,88,88,40,40,40,0,0,2
Mehidy Hasan Miraz ,BAN,2017,2024,100,99,40,40,40,0,0,3
Najibullah Zadran ,Afghanistan,2012,2023,92,91,40,40,40,0,0,3
MD Patel ,United States of America,2019,2024,59,59,40,38,13,25,2,3
KP Pietersen (ENG/ICC),NA,2004,2013,136,135,40,40,40,0,0,2
Saqlain Mushtaq ,Pakistan,1995,2003,169,166,40,40,40,0,0,2
RJ Shastri ,India,1981,1992,150,148,40,40,40,0,0,2
Soumya Sarkar ,BAN,2014,2024,72,71,40,40,40,0,0,4
SV Carlisle ,Zimbabwe,1995,2005,111,111,39,39,39,0,0,3
VVS Laxman ,India,1998,2006,86,85,39,39,39,0,0,4
CH Lloyd ,West Indies,1973,1985,87,87,39,39,39,0,0,3
PA Patel ,India,2003,2012,38,36,39,30,0,30,9,4
TE Blain ,New Zealand,1986,1994,38,38,38,37,1,36,1,4
DSBP Kuruppu ,Sri Lanka,1983,1990,54,54,38,30,4,26,8,4
DL Murray ,West Indies,1973,1980,26,26,38,37,0,37,1,4
HDRL Thirimanne ,Sri Lanka,2010,2019,127,125,38,38,38,0,0,2
Azhar Mahmood ,Pakistan,1996,2007,143,140,37,37,37,0,0,2
AG Cremer ,Zimbabwe,2009,2018,96,95,37,37,37,0,0,2
GD McGrath (AUS/ICC),NA,1993,2007,250,248,37,37,37,0,0,3
S Matsikenyeri ,Zimbabwe,2002,2015,113,113,37,37,37,0,0,3
BKV Prasad ,India,1994,2001,161,160,37,37,37,0,0,3
K Rabada ,South Africa,2015,2023,101,99,37,37,37,0,0,2
Sabbir Rahman ,BAN,2014,2019,66,65,37,37,37,0,0,3
RG Twose ,New Zealand,1995,2001,87,87,37,37,37,0,0,2
DB Vengsarkar ,India,1976,1991,129,127,37,37,37,0,0,3
CL White ,Australia,2005,2018,91,90,37,37,37,0,0,3
J Botha (Afr/SA),NA,2005,2012,78,77,36,36,36,0,0,3
IT Botham ,England,1976,1992,116,116,36,36,36,0,0,2
AN Cook ,England,2006,2014,92,91,36,36,36,0,0,2
HH Dippenaar (Afr/SA),NA,1999,2007,107,106,36,36,34,2,0,3
G Gambhir ,India,2003,2013,147,144,36,36,36,0,0,3
GB Hogg ,Australia,1996,2008,123,121,36,36,36,0,0,2
Imran Khan ,Pakistan,1974,1992,175,172,36,36,36,0,0,3
SMH Kirmani ,India,1976,1986,49,48,36,27,0,27,9,5
GJ Whittall ,Zimbabwe,1993,2003,147,146,36,36,36,0,0,4
Abdul Razzaq (Asia/PAK),NA,1996,2011,265,262,35,35,35,0,0,2
RS Bopara ,England,2007,2015,120,118,35,35,35,0,0,2
DM Bravo ,West Indies,2009,2022,122,119,35,35,35,0,0,3
MJ Greatbatch ,New Zealand,1988,1996,84,84,35,35,34,1,0,2
MG Johnson ,Australia,2005,2015,153,152,35,35,35,0,0,2
L Klusener ,South Africa,1996,2004,171,169,35,35,35,0,0,2
M Labuschagne ,Australia,2020,2024,59,59,35,35,35,0,0,4
MR Marsh ,Australia,2011,2024,93,93,35,35,35,0,0,4
Mohammad Ashraful (Asia/BAN),NA,2001,2013,177,177,35,35,35,0,0,2
Rohan Mustafa ,United Arab Emirates,2014,2023,81,81,35,35,35,0,0,2
Waqar Younis ,Pakistan,1989,2003,262,259,35,35,35,0,0,2
CJ Chibhabha ,Zimbabwe,2005,2023,109,107,34,34,34,0,0,2
HDPK Dharmasena ,Sri Lanka,1994,2004,141,140,34,34,34,0,0,2
MA Leask ,Scotland,2014,2024,80,79,34,34,34,0,0,3
AR McBrine ,Ireland,2014,2024,90,87,34,34,34,0,0,3
Nasir Hossain ,BAN,2011,2018,65,65,34,34,34,0,0,2
PL Taylor ,Australia,1987,1992,83,83,34,34,34,0,0,2
A Vala ,Papau New Guinea,2014,2023,66,66,34,34,34,0,0,3
N Boje (Afr/SA),NA,1995,2005,115,113,33,33,33,0,0,2
NH Fairbrother ,England,1987,1999,75,75,33,33,33,0,0,3
KM Jadhav ,India,2014,2020,73,72,33,33,33,0,0,3
RS Kalpage ,Sri Lanka,1992,1999,86,86,33,33,33,0,0,3
JM Kemp (Afr/SA),NA,2001,2007,85,84,33,33,33,0,0,3
Ramiz Raja ,Pakistan,1985,1997,198,193,33,33,33,0,0,2
Rashid Khan ,Afghanistan,2015,2024,108,105,33,33,33,0,0,3
RR Singh ,India,1989,2001,136,135,33,33,33,0,0,2
CJO Smith ,Scotland,2006,2009,27,26,33,22,0,22,11,5
Abdur Razzak ,BAN,2004,2014,153,153,32,32,32,0,0,2
Ghulam Shabber ,United Arab Emirates,2017,2019,23,23,32,30,0,30,2,4
HH Pandya ,India,2016,2023,86,84,32,32,32,0,0,2
Shubman Gill ,India,2019,2024,47,45,32,32,32,0,0,2
J Srinath ,India,1991,2003,229,227,32,32,32,0,0,2
RW Taylor ,England,1973,1984,27,27,32,26,0,26,6,4
R Ashwin ,India,2010,2023,116,115,31,31,31,0,0,3
W Barresi ,NED,2010,2024,52,52,31,23,10,13,8,3
DL Houghton ,Zimbabwe,1983,1997,63,63,31,29,19,10,2,4
CK Kapugedera ,Sri Lanka,2006,2017,102,100,31,31,31,0,0,2
AJ Lamb ,England,1982,1992,122,122,31,31,31,0,0,2
SL Malinga ,Sri Lanka,2004,2019,226,220,31,31,31,0,0,2
GR Marsh ,Australia,1986,1992,117,117,31,31,31,0,0,2
Mohammed Shami ,India,2013,2023,101,100,31,31,31,0,0,2
M Morkel (Afr/SA),NA,2007,2018,117,114,31,31,31,0,0,3
DR Smith ,West Indies,2004,2015,105,103,31,31,31,0,0,2
RG de Alwis ,Sri Lanka,1983,1988,31,31,30,27,0,27,3,5
J Garner ,West Indies,1977,1987,98,98,30,30,30,0,0,3
LK Germon ,New Zealand,1994,1997,37,37,30,21,0,21,9,4
JR Hazlewood ,Australia,2010,2024,91,91,30,30,30,0,0,2
MA Holding ,West Indies,1976,1987,102,102,30,30,30,0,0,3
SS Karim ,India,1997,2000,34,34,30,27,0,27,3,4
WK Lees ,New Zealand,1979,1983,31,31,30,28,0,28,2,4
Mushtaq Ahmed ,Pakistan,1989,2003,144,144,30,30,30,0,0,2
HM Nicholls ,New Zealand,2015,2024,78,75,30,30,30,0,0,2
M Ntini (ICC/SA),NA,1998,2009,173,171,30,30,30,0,0,2
CS Pandit ,India,1986,1992,36,36,30,15,0,15,15,4
PA Strang ,Zimbabwe,1994,2001,95,94,30,30,30,0,0,2
Aftab Ahmed ,BAN,2004,2010,85,85,29,29,29,0,0,3
DS Airee ,NEP,2018,2024,60,59,29,29,29,0,0,3
TM Alderman ,Australia,1981,1991,65,65,29,29,29,0,0,3
Alok Kapali ,BAN,2002,2011,69,69,29,29,29,0,0,2
PR Downton ,England,1977,1988,28,28,29,26,0,26,3,4
AJ Hall ,South Africa,1999,2007,88,87,29,29,29,0,0,2
WW Hinds ,West Indies,1999,2010,119,119,29,29,29,0,0,2
DJ Hussey ,Australia,2008,2013,69,69,29,29,29,0,0,2
B Kumar ,India,2012,2022,121,120,29,29,29,0,0,2
AK Markram ,South Africa,2017,2024,71,69,29,29,29,0,0,3
R Mutumbami ,Zimbabwe,2014,2020,36,36,29,24,2,22,5,4
GP Swann ,England,2000,2013,79,78,29,29,29,0,0,3
DC Thomas ,West Indies,2009,2013,21,21,29,23,0,23,6,3
Wahab Riaz ,Pakistan,2008,2020,91,90,29,29,29,0,0,2
Ahmed Shehzad ,Pakistan,2009,2017,81,80,28,28,28,0,0,2
PW Borren ,NED,2006,2014,58,58,28,28,28,0,0,3
JJ Crowe ,New Zealand,1983,1990,75,74,28,28,28,0,0,2
AA Donald ,South Africa,1991,2003,164,162,28,28,28,0,0,2
GC Dyer ,Australia,1986,1988,23,23,28,24,0,24,4,4
MJ Henry ,New Zealand,2014,2023,82,80,28,28,28,0,0,2
GJ Hopkins ,New Zealand,2004,2010,25,23,28,27,0,27,1,5
JP Inglis ,Australia,2022,2024,26,26,28,25,1,24,3,5
Mohammad Rafique (Asia/BAN),NA,1995,2007,125,125,28,28,28,0,0,2
TM Odoyo (Afr/KENYA),NA,1996,2014,136,136,28,28,28,0,0,2
RR Pant ,India,2018,2024,31,30,28,27,4,23,1,4
RJ Peterson ,South Africa,2002,2014,79,79,28,28,28,0,0,2
LMP Simmons ,West Indies,2006,2015,68,68,28,28,26,2,0,2
DW Steyn (Afr/SA),NA,2005,2019,125,124,28,28,28,0,0,2
BA Young ,New Zealand,1990,1999,74,73,28,28,22,6,0,3
KLT Arthurton ,West Indies,1988,1999,105,104,27,27,27,0,0,2
T Bavuma ,South Africa,2016,2024,42,41,27,27,27,0,0,4
F Behardien ,South Africa,2013,2018,59,58,27,27,27,0,0,2
SCJ Broad ,England,2006,2016,121,121,27,27,27,0,0,2
J Charles ,West Indies,2012,2023,58,58,27,25,13,12,2,3
MG Erasmus ,Namibia,2019,2024,52,52,27,27,27,0,0,3
CRD Fernando (Asia/SL),NA,2001,2012,147,146,27,27,27,0,0,3
Gulbadin Naib ,Afghanistan,2011,2024,86,84,27,27,27,0,0,3
Sir RJ Hadlee ,New Zealand,1973,1990,115,113,27,27,27,0,0,2
AD Hales ,England,2014,2019,70,68,27,27,27,0,0,2
KJ Hughes ,Australia,1977,1985,97,96,27,27,27,0,0,2
EC Joyce (ENG/IRE),NA,2006,2018,78,75,27,27,27,0,0,2
CJ McDermott ,Australia,1985,1996,138,138,27,27,27,0,0,1
HG Munsey ,Scotland,2017,2024,59,58,27,27,27,0,0,3
JDS Neesham ,New Zealand,2013,2023,76,76,27,27,27,0,0,2
M Prabhakar ,India,1984,1996,130,128,27,27,27,0,0,3
Rahmat Shah ,Afghanistan,2013,2024,117,114,27,27,27,0,0,2
CA Walsh ,West Indies,1985,2000,205,204,27,27,27,0,0,1
DJ Willey ,England,2015,2023,73,72,27,27,27,0,0,2
Aarif Sheikh ,NEP,2018,2024,57,56,26,26,26,0,0,3
NW Bracken ,Australia,2001,2009,116,116,26,26,26,0,0,2
KJ Coetzer ,Scotland,2008,2023,89,87,26,26,26,0,0,2
PAJ DeFreitas ,England,1987,1997,103,103,26,26,26,0,0,2
JEC Franklin ,New Zealand,2001,2013,110,109,26,26,26,0,0,2
Habibul Bashar ,BAN,1995,2007,111,111,26,26,26,0,0,2
Imran Nazir ,Pakistan,1999,2009,79,78,26,26,26,0,0,3
DS Lehmann ,Australia,1996,2005,117,116,26,26,26,0,0,3
MF Maharoof ,Sri Lanka,2004,2016,109,107,26,26,26,0,0,2
LE Plunkett ,England,2005,2019,89,87,26,26,26,0,0,2
AG Prince (Afr/SA),NA,2002,2007,52,51,26,26,26,0,0,4
RA Smith ,England,1988,1996,71,71,26,26,26,0,0,2
TP Ura ,Papau New Guinea,2014,2023,61,61,26,26,26,0,0,2
HE van der Dussen ,South Africa,2019,2024,65,62,26,26,26,0,0,2
GP Wickramasinghe ,Sri Lanka,1990,2002,134,134,26,26,26,0,0,2
CB Wishart ,Zimbabwe,1996,2005,90,90,26,26,26,0,0,2
B Zuiderent ,NED,1996,2011,57,57,26,26,26,0,0,2
Ahmed Raza ,United Arab Emirates,2014,2022,53,53,25,25,25,0,0,3
K Doriga ,Papau New Guinea,2017,2023,39,39,25,19,2,17,6,4
D Gough (ENG/ICC),NA,1994,2006,159,157,25,25,25,0,0,1
JR Hopes ,Australia,2005,2010,84,83,25,25,25,0,0,2
Imran Tahir ,South Africa,2011,2019,107,104,25,25,25,0,0,2
DT Johnston ,Ireland,2006,2013,67,65,25,25,25,0,0,2
DJ Mitchell ,New Zealand,2021,2023,39,39,25,25,25,0,0,3
Naseem Khushi ,OMA,2020,2023,32,32,25,22,1,21,3,3
DJ Nash ,New Zealand,1992,2002,81,80,25,25,25,0,0,3
AR Patel ,India,2014,2024,60,58,25,25,25,0,0,3
N Pooran ,West Indies,2019,2023,61,60,25,23,21,2,2,2
Rahmanullah Gurbaz ,Afghanistan,2021,2024,46,46,25,23,2,21,2,3
DW Randall ,England,1976,1985,49,49,25,25,25,0,0,2
PR Reiffel ,Australia,1992,1999,92,92,25,25,25,0,0,2
Saeed Ajmal ,Pakistan,2008,2015,113,112,25,25,25,0,0,1
MP Vaughan ,England,2001,2007,86,85,25,25,25,0,0,3
Aaqib Javed ,Pakistan,1988,1998,163,159,24,24,24,0,0,1
Asghar Afghan ,Afghanistan,2009,2021,114,111,24,24,24,0,0,2
PJ Cummins ,Australia,2011,2024,90,90,24,24,24,0,0,2
V Dahiya ,India,2000,2001,19,19,24,19,0,19,5,3
BFW de Leede ,NED,2018,2024,47,47,24,24,24,0,0,2
SS Dighe ,India,2000,2001,23,23,24,19,0,19,5,4
NM Hauritz ,Australia,2002,2011,58,57,24,24,24,0,0,2
SS Iyer ,India,2017,2024,62,60,24,24,24,0,0,2
AS Joseph ,West Indies,2016,2024,73,72,24,24,24,0,0,2
E Lewis ,West Indies,2016,2024,61,59,24,24,24,0,0,2
Muhammad Waseem ,United Arab Emirates,2022,2024,56,56,24,24,24,0,0,2
S Viswanath ,India,1985,1988,22,22,24,17,0,17,7,5
Wasim Raja ,Pakistan,1973,1985,54,52,24,24,24,0,0,2
Zeeshan Maqsood ,OMA,2019,2024,48,48,24,24,24,0,0,2
MR Adair ,Ireland,2019,2024,51,49,23,23,23,0,0,2
M Amarnath ,India,1975,1989,85,84,23,23,23,0,0,2
RP Burl ,Zimbabwe,2017,2024,52,50,23,23,23,0,0,3
SL Campbell ,West Indies,1994,2001,90,90,23,23,23,0,0,3
GS Chappell ,Australia,1971,1983,74,72,23,23,23,0,0,2
DD Ebrahim ,Zimbabwe,2001,2005,82,82,23,23,23,0,0,2
SO Hetmyer ,West Indies,2017,2024,56,54,23,23,20,3,0,3
AH Jones ,New Zealand,1987,1995,87,87,23,23,23,0,0,2
Junaid Siddique ,BAN,2007,2011,54,54,23,23,22,1,0,3
GR Larsen ,New Zealand,1990,1999,121,121,23,23,23,0,0,1
S Lee ,Australia,1995,2001,45,44,23,23,23,0,0,2
SV Manjrekar ,India,1988,1996,74,74,23,23,23,0,0,2
GRJ Matthews ,Australia,1984,1993,59,59,23,23,23,0,0,3
AF Milne ,New Zealand,2012,2024,50,48,23,23,23,0,0,3
PJ Moor ,Zimbabwe,2014,2019,49,48,23,22,6,16,1,4
PA Nixon ,England,2007,2007,19,19,23,20,0,20,3,2
DN Patel ,New Zealand,1987,1997,75,75,23,23,23,0,0,2
SW Poynter ,Ireland,2014,2019,21,21,23,22,3,19,1,4
PL Symcox ,South Africa,1993,1999,80,80,23,23,23,0,0,2
HT Tector ,Ireland,2020,2024,48,46,23,23,23,0,0,2
TJ Zoehrer ,Australia,1986,1994,22,22,23,21,0,21,2,4
Zulqarnain ,Pakistan,1985,1989,16,14,23,18,0,18,5,4
Afsar Zazai ,Afghanistan,2014,2017,17,16,22,20,0,20,2,3
B Bhandari ,NEP,2019,2022,17,17,22,21,0,21,1,4
RL Chase ,West Indies,2017,2024,51,49,22,22,22,0,0,2
MW Gatting ,England,1977,1993,92,92,22,22,22,0,0,2
SM Gavaskar ,India,1974,1987,108,107,22,22,22,0,0,4
AF Giles ,England,1997,2005,62,62,22,22,22,0,0,3
RR Hendricks ,South Africa,2018,2024,38,37,22,22,22,0,0,3
JN Loftie-Eaton ,Namibia,2021,2024,40,40,22,22,17,5,0,3
SE Marsh ,Australia,2008,2019,73,73,22,22,22,0,0,2
PL Mommsen ,Scotland,2010,2017,44,43,22,22,22,0,0,2
C Munro ,New Zealand,2013,2019,57,57,22,22,22,0,0,2
P Nissanka ,Sri Lanka,2021,2024,61,60,22,22,22,0,0,2
SP O'Donnell ,Australia,1985,1991,87,87,22,22,22,0,0,2
KAJ Roach ,West Indies,2008,2022,95,93,22,22,22,0,0,2
RR Rossouw ,South Africa,2014,2016,36,35,22,22,22,0,0,4
MN Waller ,Zimbabwe,2009,2018,79,79,22,22,22,0,0,1
RGD Willis ,England,1973,1984,64,64,22,22,22,0,0,2
UT Yadav ,India,2010,2018,75,73,22,22,22,0,0,3
NP Kenjige ,United States of America,2019,2024,52,52,21,21,21,0,0,2
Abdul Qadir ,Pakistan,1983,1993,104,102,21,21,21,0,0,2
CJA Amini ,Papau New Guinea,2014,2023,49,49,21,21,21,0,0,2
DL Bairstow ,England,1979,1984,21,21,21,17,0,17,4,3
JP Faulkner ,Australia,2013,2017,69,69,21,21,21,0,0,1
Imrul Kayes ,BAN,2008,2018,78,78,21,21,21,0,0,2
ND McKenzie ,South Africa,2000,2009,64,64,21,21,21,0,0,3
Manzoor Elahi ,Pakistan,1984,1995,54,54,21,21,21,0,0,2
D Mongia ,India,2001,2007,57,56,21,21,21,0,0,3
TM Moody ,Australia,1987,1999,76,76,21,21,21,0,0,2
S Movva ,Canada,2024,2024,15,15,21,19,2,17,2,4
Mudassar Nazar ,Pakistan,1977,1989,122,119,21,21,21,0,0,2
A Nel ,South Africa,2001,2008,79,77,21,21,21,0,0,2
IK Pathan ,India,2004,2012,120,118,21,21,21,0,0,1
MSK Prasad ,India,1998,1999,17,17,21,14,0,14,7,5
Samiullah Shinwari ,Afghanistan,2009,2019,84,84,21,21,21,0,0,2
OA Shah ,England,2001,2009,71,71,21,21,21,0,0,2
SM Sharif ,Scotland,2011,2024,82,81,21,21,21,0,0,2
RV Uthappa ,India,2006,2015,46,44,21,19,15,4,2,3
AR White ,Ireland,2006,2014,61,61,21,21,21,0,0,2
AR Whittall ,Zimbabwe,1996,2000,63,63,21,21,21,0,0,3
Ashraf Ali ,Pakistan,1980,1985,16,16,20,17,0,17,3,3
S Bau ,Papau New Guinea,2016,2023,57,57,20,20,20,0,0,2
SW Billings ,England,2015,2022,28,28,20,19,15,4,1,2
GB Brent ,Zimbabwe,1996,2008,70,70,20,20,20,0,0,2
TT Bresnan ,England,2006,2015,85,84,20,20,20,0,0,2
AF Buurman ,NED,2007,2011,17,17,20,17,2,15,3,3
CK Coventry ,Zimbabwe,2003,2015,39,39,20,19,19,0,1,1
DN Crookes ,South Africa,1994,2000,32,32,20,20,20,0,0,2
M Dillon ,West Indies,1997,2005,108,107,20,20,20,0,0,2
JS Foster ,England,2001,2002,11,11,20,13,0,13,7,3
MW Goodwin ,Zimbabwe,1998,2000,71,71,20,20,20,0,0,2
JK Kamande ,Kenya,1999,2011,86,86,20,20,20,0,0,2
RAS Lakmal ,Sri Lanka,2009,2021,86,84,20,20,20,0,0,1
CC Lewis ,England,1990,1998,53,53,20,20,20,0,0,2
DA Minors ,BER,2006,2007,20,20,20,16,4,12,4,3
RS Morton ,West Indies,2002,2010,56,55,20,20,20,0,0,3
Rubel Hossain ,BAN,2009,2021,104,103,20,20,20,0,0,2
Salman Butt ,Pakistan,2004,2010,78,77,20,20,20,0,0,2
Shoaib Akhtar (Asia/ICC/PAK),NA,1998,2011,163,162,20,20,20,0,0,2
NS Sidhu ,India,1987,1998,136,135,20,20,20,0,0,2
LPC Silva ,Sri Lanka,1999,2011,75,73,20,20,20,0,0,3
SAR Silva ,Sri Lanka,1984,1985,20,20,20,17,0,17,3,3
Suraj Kumar ,OMA,2019,2023,24,24,20,18,0,18,2,3
JE Taylor ,West Indies,2003,2017,90,88,20,20,20,0,0,2
SR Taylor ,United States of America,2019,2024,49,49,20,20,20,0,0,2
DR Tuffey ,New Zealand,2000,2010,94,92,20,20,20,0,0,3
BJ Watling ,New Zealand,2010,2018,28,28,20,20,6,14,0,3
MRJ Watt ,Scotland,2016,2024,71,70,20,20,20,0,0,1
Akram Raza ,Pakistan,1989,1995,49,49,19,19,19,0,0,2
AJ Bichel ,Australia,1997,2004,67,66,19,19,19,0,0,2
JG Bracewell ,New Zealand,1983,1990,53,52,19,19,19,0,0,3
BL Cairns ,New Zealand,1974,1985,78,77,19,19,19,0,0,2
EJ Chatfield ,New Zealand,1979,1989,114,112,19,19,19,0,0,2
SS Cottrell ,West Indies,2015,2021,38,36,19,19,19,0,0,3
XJ Doherty ,Australia,2010,2015,60,60,19,19,19,0,0,2
JE Emburey ,England,1980,1993,61,61,19,19,19,0,0,2
WIA Fernando ,Sri Lanka,2016,2024,47,46,19,19,19,0,0,3
JM How ,New Zealand,2005,2011,41,40,19,19,19,0,0,4
Ikram Alikhil ,Afghanistan,2019,2024,28,27,19,15,0,15,4,3
NC Johnson ,Zimbabwe,1998,2000,48,48,19,19,19,0,0,2
CJ Jordan ,England,2013,2022,35,35,19,19,19,0,0,2
SB Joshi ,India,1996,2001,69,68,19,19,19,0,0,2
Khawar Ali ,OMA,2019,2022,34,34,19,19,19,0,0,2
Mohammad Sami ,Pakistan,2001,2015,87,86,19,19,19,0,0,2
JF Mooney ,Ireland,2006,2015,64,62,19,19,19,0,0,2
DK Morrison ,New Zealand,1987,1996,96,96,19,19,19,0,0,2
Naeem Islam ,BAN,2008,2014,59,59,19,19,19,0,0,2
Nawroz Mangal ,Afghanistan,2009,2016,49,49,19,19,19,0,0,2
CJ Nevin ,New Zealand,2000,2003,37,36,19,16,2,14,3,3
KH Prajapati ,OMA,2021,2024,37,37,19,19,19,0,0,2
Sandeep Goud ,OMA,2019,2024,39,39,19,19,19,0,0,2
SMSM Senanayake ,Sri Lanka,2012,2015,49,48,19,19,19,0,0,3
Shadab Khan ,Pakistan,2017,2023,70,70,19,19,19,0,0,2
I Sharma ,India,2007,2016,80,78,19,19,19,0,0,1
MC Snedden ,New Zealand,1980,1990,93,92,19,19,19,0,0,1
AO Suji ,Kenya,1996,2008,60,60,19,19,19,0,0,2
CD Wallace ,Scotland,2012,2022,32,32,19,17,12,5,2,4
V Yadav ,India,1992,1994,19,19,19,12,0,12,7,3
Asif Mujtaba ,Pakistan,1986,1996,66,66,18,18,18,0,0,3
Basil Hameed ,United Arab Emirates,2019,2024,48,48,18,18,18,0,0,2
JJ Bumrah ,India,2016,2023,89,88,18,18,18,0,0,2
AR Cusack ,Ireland,2007,2015,59,55,18,18,18,0,0,2
PG Fulton ,New Zealand,2004,2009,49,48,18,18,18,0,0,2
IJ Gould ,England,1983,1983,18,18,18,15,0,15,3,3
Hashmatullah Shahidi ,Afghanistan,2013,2024,84,83,18,18,18,0,0,1
AC Hudson ,South Africa,1991,1997,89,88,18,18,18,0,0,2
Jatinder Singh ,OMA,2019,2024,53,53,18,18,18,0,0,2
AN Kervezee ,NED,2006,2012,39,39,18,18,18,0,0,3
GF Lawson ,Australia,1980,1989,79,79,18,18,18,0,0,2
S Madan Lal ,India,1974,1987,67,65,18,18,18,0,0,2
RS Madugalle ,Sri Lanka,1979,1988,63,63,18,18,18,0,0,2
JP Maher ,Australia,1998,2003,26,26,18,18,10,8,0,3
Maninder Singh ,India,1983,1993,59,58,18,18,18,0,0,2
HJH Marshall ,New Zealand,2003,2007,66,65,18,18,18,0,0,3
NO Miller ,West Indies,2008,2018,50,48,18,18,18,0,0,3
Mosaddek Hossain ,BAN,2016,2022,43,42,18,18,18,0,0,2
Mustafizur Rahman ,BAN,2015,2024,107,106,18,18,18,0,0,2
A Nehra (Asia/IND),NA,2001,2011,120,120,18,18,18,0,0,2
RR Patel ,Kenya,2008,2014,39,39,18,18,18,0,0,2
RK Paudel ,NEP,2018,2024,68,67,18,18,18,0,0,2
Raqibul Hasan ,BAN,2008,2011,55,55,18,18,18,0,0,2
WP Saha ,India,2010,2014,9,8,18,17,0,17,1,4
PM Seelaar ,NED,2006,2022,57,57,18,18,18,0,0,2
MD Shanaka ,Sri Lanka,2016,2024,71,70,18,18,18,0,0,2
Shayan Jahangir ,United States of America,2022,2024,24,24,18,17,8,9,1,3
MP Stoinis ,Australia,2015,2024,71,71,18,18,18,0,0,1
SA Thomson ,New Zealand,1990,1996,56,56,18,18,18,0,0,2
MA Vermeulen ,Zimbabwe,2000,2009,43,43,18,18,18,0,0,3
DP Viljoen ,Zimbabwe,1997,2001,53,53,18,18,18,0,0,2
SC Williams ,West Indies,1994,1999,57,57,18,18,18,0,0,3
LJ Wright ,England,2007,2014,50,50,18,18,18,0,0,2
A Zampa ,Australia,2016,2024,106,106,18,18,18,0,0,2
KIC Asalanka ,Sri Lanka,2021,2024,68,68,17,17,17,0,0,2
DP Conway ,New Zealand,2021,2023,32,32,17,17,17,0,0,3
TLW Cooper ,NED,2010,2023,32,32,17,17,17,0,0,2
JM Davison ,Canada,2003,2011,32,32,17,17,17,0,0,2
C de Grandhomme ,New Zealand,2012,2022,45,45,17,17,17,0,0,3
GD Elliott ,New Zealand,2008,2016,83,83,17,17,17,0,0,2
TJ Friend ,Zimbabwe,2000,2004,51,51,17,17,17,0,0,2
Haris Sohail ,Pakistan,2013,2023,45,44,17,17,17,0,0,2
IJ Harvey ,Australia,1997,2004,73,72,17,17,17,0,0,2
PW Hasaranga ,Sri Lanka,2017,2024,58,57,17,17,17,0,0,2
TM Head ,Australia,2016,2024,69,69,17,17,17,0,0,2
Iftikhar Ahmed ,Pakistan,2015,2023,28,28,17,17,17,0,0,2
FDM Karunaratne ,Sri Lanka,2011,2023,50,50,17,17,17,0,0,2
Khaled Mahmud ,BAN,1998,2006,77,77,17,17,17,0,0,2
EB McSweeney ,New Zealand,1986,1987,16,15,17,14,0,14,3,3
PJ Ongondo (Afr/KENYA),NA,1999,2011,79,79,17,17,17,0,0,2
YK Pathan ,India,2008,2012,57,56,17,17,17,0,0,3
AL Phehlukwayo ,South Africa,2016,2024,83,81,17,17,17,0,0,2
RW Price ,Zimbabwe,2002,2012,102,102,17,17,17,0,0,2
WB Rankin (ENG/IRE),NA,2007,2020,75,73,17,17,17,0,0,2
AT Rayudu ,India,2013,2019,55,53,17,17,17,0,0,2
CJ Richards ,England,1981,1988,22,22,17,16,0,16,1,3
TT Samaraweera ,Sri Lanka,1998,2011,53,51,17,17,17,0,0,2
L Siaka ,Papau New Guinea,2014,2022,47,47,17,17,17,0,0,2
MS Sinclair ,New Zealand,2000,2009,54,54,17,17,15,2,0,2
Umar Gul ,Pakistan,2003,2016,130,128,17,17,17,0,0,2
LV van Beek ,NED,2021,2023,33,33,17,17,17,0,0,3
GM Wood ,Australia,1978,1989,83,80,17,17,17,0,0,2
SA Yadav ,India,2021,2023,37,36,17,17,17,0,0,2
Aamer Malik ,Pakistan,1988,1994,24,24,16,13,3,10,3,2
Aaron Jones ,United States of America,2019,2024,48,48,16,16,16,0,0,2
CWJ Athey ,England,1980,1988,31,31,16,16,16,0,0,3
JJ Atkinson ,Hong Kong,2008,2017,9,9,16,10,0,10,6,4
WKM Benjamin ,West Indies,1986,1995,85,85,16,16,16,0,0,1
YS Chahal ,India,2016,2023,72,71,16,16,16,0,0,2
N Chopra ,India,1998,2000,39,38,16,16,16,0,0,2
Dawlat Zadran ,Afghanistan,2011,2019,82,80,16,16,16,0,0,2
RL Dias ,Sri Lanka,1979,1987,58,58,16,16,16,0,0,2
BN French ,England,1985,1988,13,13,16,13,0,13,3,3
JN Frylinck ,Namibia,2019,2024,38,38,16,16,16,0,0,2
BJ Hodge ,Australia,2005,2007,25,25,16,16,16,0,0,2
AJ Hosein ,West Indies,2021,2023,38,38,16,16,16,0,0,2
GP Howarth ,New Zealand,1975,1985,70,69,16,16,16,0,0,2
APE Knott ,England,1971,1977,20,19,16,15,0,15,1,4
Kuldeep Yadav ,India,2017,2024,106,104,16,16,16,0,0,1
L Louwrens ,Namibia,2022,2024,26,26,16,16,7,9,0,3
T Mishra ,Kenya,2006,2013,42,42,16,16,16,0,0,2
DA Murray ,West Indies,1973,1981,10,10,16,16,0,16,0,3
TJ Murtagh ,Ireland,2012,2019,58,57,16,16,16,0,0,1
Naved-ul-Hasan ,Pakistan,2003,2010,74,72,16,16,16,0,0,2
SN Netravalkar ,United States of America,2019,2024,56,56,16,16,16,0,0,3
GD Phillips ,New Zealand,2022,2024,33,32,16,16,16,0,0,2
R Powell ,West Indies,2016,2023,51,50,16,16,16,0,0,2
A Ratra ,India,2002,2002,12,12,16,11,0,11,5,3
GJ Rennie ,Zimbabwe,1996,2003,40,40,16,16,16,0,0,2
RD Shah ,Kenya,1998,2007,56,56,16,16,16,0,0,2
VS Solanki ,England,2000,2006,51,50,16,16,16,0,0,2
N Vanua ,Papau New Guinea,2014,2023,57,57,16,16,16,0,0,2
Zaheer Abbas ,Pakistan,1974,1985,62,60,16,16,16,0,0,2
Anamul Haque ,BAN,2012,2024,49,49,15,15,9,6,0,3
Anil Dalpat ,Pakistan,1984,1986,15,14,15,13,0,13,2,3
MA Atherton ,England,1990,1998,54,54,15,15,15,0,0,2
Basit Ali ,Pakistan,1993,1996,50,49,15,15,15,0,0,2
TA Blundell ,New Zealand,2020,2023,12,11,15,13,1,12,2,3
SE Bond ,New Zealand,2002,2010,82,80,15,15,15,0,0,2
SKL de Silva ,Sri Lanka,1997,1997,11,11,15,9,0,9,6,3
PS de Villiers ,South Africa,1992,1997,83,82,15,15,15,0,0,2
ST Finn ,England,2011,2017,69,67,15,15,15,0,0,2
DT Hondo ,Zimbabwe,2001,2005,56,56,15,15,15,0,0,1
Imam-ul-Haq ,Pakistan,2017,2023,72,71,15,15,15,0,0,2
Ishan Kishan ,India,2021,2023,27,26,15,13,3,10,2,3
VG Kambli ,India,1991,2000,104,101,15,15,15,0,0,1
MD Marshall ,West Indies,1980,1992,136,134,15,15,15,0,0,2
B McMullen ,Scotland,2022,2024,26,26,15,15,15,0,0,3
BAW Mendis ,Sri Lanka,2008,2015,87,85,15,15,15,0,0,2
JA Morkel (Afr/SA),NA,2004,2012,58,58,15,15,15,0,0,2
L Ngidi ,South Africa,2018,2024,62,61,15,15,15,0,0,3
Noor Ali Zadran ,Afghanistan,2009,2019,51,49,15,15,15,0,0,2
AR Nurse ,West Indies,2016,2019,54,52,15,15,15,0,0,3
AA Obanda ,Kenya,2007,2014,49,49,15,15,15,0,0,2
JL Ontong (Afr/SA),NA,2001,2012,28,27,15,15,15,0,0,2
KMA Paul ,West Indies,2018,2023,30,30,15,15,15,0,0,2
Rizwan Cheema ,Canada,2008,2013,33,32,15,15,15,0,0,2
JD Ryder ,New Zealand,2008,2014,48,48,15,15,15,0,0,2
Shoaib Khan ,OMA,2021,2024,31,31,15,15,15,0,0,2
Sohail Tanvir ,Pakistan,2007,2014,62,60,15,15,15,0,0,2
CM Spearman ,New Zealand,1995,2001,51,51,15,15,15,0,0,1
BC Strang ,Zimbabwe,1995,2001,49,48,15,15,15,0,0,2
HA Varaiya ,Kenya,2006,2014,63,63,15,15,15,0,0,2
KJ Wadsworth ,New Zealand,1973,1976,13,13,15,13,0,13,2,3
SA Wijeyeratne ,Canada,2023,2024,10,10,15,12,0,12,3,4
WA Young ,New Zealand,2021,2024,34,32,15,15,15,0,0,2
Agha Salman ,Pakistan,2022,2024,24,24,14,14,14,0,0,3
Asad Shafiq ,Pakistan,2010,2017,60,59,14,14,14,0,0,2
EAE Baptiste ,West Indies,1983,1990,43,43,14,14,14,0,0,2
SSJ Brooks ,West Indies,2022,2023,29,29,14,14,14,0,0,2
AC Cummins (CAN/WI),NA,1991,2007,76,75,14,14,14,0,0,2
A Dananjaya ,Sri Lanka,2012,2024,42,41,14,14,14,0,0,2
LH Ferguson ,New Zealand,2016,2023,65,64,14,14,14,0,0,1
DW Fleming ,Australia,1994,2001,88,88,14,14,14,0,0,1
HA Gomes ,West Indies,1978,1987,83,83,14,14,14,0,0,1
MD Gunathilaka ,Sri Lanka,2015,2022,47,46,14,14,14,0,0,2
PSP Handscomb ,Australia,2017,2019,22,22,14,14,9,5,0,3
HMRKB Herath ,Sri Lanka,2004,2015,71,69,14,14,14,0,0,2
Imran Farhat ,Pakistan,2001,2013,58,58,14,14,14,0,0,1
HH Kanitkar ,India,1997,2000,34,34,14,14,14,0,0,2
BA King ,West Indies,2019,2024,43,43,14,14,14,0,0,2
Mansoor Akhtar ,Pakistan,1980,1990,41,40,14,14,14,0,0,2
BJ McCarthy ,Ireland,2016,2024,45,45,14,14,14,0,0,2
LRD Mendis ,Sri Lanka,1975,1989,79,79,14,14,14,0,0,2
Mohammad Nawaz (3) ,Pakistan,2016,2023,37,37,14,14,14,0,0,2
AA Mulla ,Canada,2006,2009,24,24,14,9,5,4,5,2
SP Narine ,West Indies,2011,2016,65,65,14,14,14,0,0,2
SK Patel ,United States of America,2024,2024,8,8,14,13,0,13,1,5
KOA Powell ,West Indies,2009,2018,46,45,14,14,14,0,0,2
R Rampaul ,West Indies,2003,2015,92,89,14,14,14,0,0,2
JR Ratnayeke ,Sri Lanka,1982,1990,78,78,14,14,14,0,0,2
Shafiqullah ,Afghanistan,2009,2018,24,24,14,11,3,8,3,2
G Singh ,United States of America,2021,2023,32,32,14,14,14,0,0,3
JJ Smit ,Namibia,2019,2024,41,41,14,14,14,0,0,2
IS Sodhi ,New Zealand,2015,2024,54,51,14,14,14,0,0,2
Sompal Kami ,NEP,2018,2024,61,60,14,14,14,0,0,1
CA Soper ,Papau New Guinea,2016,2023,56,56,14,14,14,0,0,2
JC Tredwell ,England,2010,2015,45,44,14,14,14,0,0,2
IJL Trott ,England,2009,2013,68,66,14,14,14,0,0,2
M van Lingen ,Namibia,2021,2024,40,40,14,14,14,0,0,3
RR Watson ,Scotland,2006,2010,35,34,14,14,14,0,0,2
MA Wood ,England,2015,2023,66,65,14,14,14,0,0,2
Yasir Hameed ,Pakistan,2003,2007,56,56,14,14,14,0,0,2
CA Young ,Ireland,2014,2024,48,45,14,14,14,0,0,2
Zahoor Khan ,United Arab Emirates,2017,2024,62,62,14,14,14,0,0,2
SA Abbott ,Australia,2014,2024,26,26,13,13,13,0,0,2
Aminul Islam ,BAN,1988,2002,39,39,13,13,13,0,0,2
Ayaan Khan ,OMA,2021,2024,41,41,13,13,13,0,0,2
HK Badani ,India,2000,2004,40,40,13,13,13,0,0,2
GS Ballance (ENG/ZIM),NA,2013,2023,21,21,13,13,13,0,0,4
C Campher ,Ireland,2020,2024,40,40,13,13,13,0,0,2
PB Dassanayake ,Sri Lanka,1993,1994,16,16,13,9,0,9,4,2
ALF de Mel ,Sri Lanka,1982,1987,57,57,13,13,13,0,0,2
Dhiman Ghosh ,BAN,2008,2008,14,14,13,9,0,9,4,4
Farhad Reza ,BAN,2006,2011,34,34,13,13,13,0,0,2
C Green ,Australia,2020,2024,28,28,13,13,13,0,0,2
DA Gunawardene ,Sri Lanka,1998,2006,61,61,13,13,13,0,0,2
Hasan Ali ,Pakistan,2016,2023,66,65,13,13,13,0,0,2
AJ Hollioake ,England,1996,1999,35,35,13,13,13,0,0,3
MS Kasprowicz ,Australia,1995,2005,43,42,13,13,13,0,0,2
SM Katich ,Australia,2001,2006,45,45,13,13,13,0,0,1
UT Khawaja ,Australia,2013,2019,40,40,13,13,13,0,0,2
LS Livingstone ,England,2021,2024,33,33,13,13,13,0,0,2
NFI McCallum ,Scotland,2006,2011,43,42,13,13,13,0,0,2
R McLaren ,South Africa,2009,2014,54,52,13,13,13,0,0,1
G Malla ,NEP,2018,2023,37,37,13,13,13,0,0,2
BMAJ Mendis ,Sri Lanka,2010,2019,58,56,13,13,13,0,0,2
Mohsin Khan ,Pakistan,1977,1986,75,73,13,13,13,0,0,2
B Muzarabani ,Zimbabwe,2018,2024,48,47,13,13,13,0,0,2
Nasir Jamshed ,Pakistan,2008,2015,48,48,13,13,13,0,0,2
Najmul Hossain Shanto ,BAN,2018,2024,47,46,13,13,13,0,0,2
HK Olonga ,Zimbabwe,1995,2003,50,50,13,13,13,0,0,2
WD Parnell ,South Africa,2009,2023,73,70,13,13,13,0,0,2
JS Patel ,New Zealand,2005,2017,43,42,13,13,13,0,0,1
DBL Powell ,West Indies,2002,2009,55,55,13,13,13,0,0,2
Shahriar Nafees ,BAN,2005,2011,75,75,13,13,13,0,0,2
Shoaib Mohammad ,Pakistan,1984,1993,63,62,13,13,13,0,0,2
Simi Singh ,Ireland,2017,2022,35,33,13,13,13,0,0,3
RP Singh ,India,2005,2011,58,58,13,13,13,0,0,1
DS Smith ,West Indies,2003,2013,47,46,13,13,13,0,0,3
RN ten Doeschate ,NED,2006,2011,33,33,13,13,13,0,0,2
R Trumpelmann ,Namibia,2021,2024,38,38,13,13,13,0,0,2
GM Turner ,New Zealand,1973,1983,41,41,13,13,13,0,0,2
DNT Zoysa ,Sri Lanka,1997,2007,95,94,13,13,13,0,0,2
Afif Hossain ,BAN,2020,2023,31,31,12,12,12,0,0,2
Akshay Homraj ,United States of America,2019,2020,8,8,12,12,0,12,0,4
Amjad Ali ,United Arab Emirates,2008,2015,17,17,12,11,7,4,1,3
PK Amre ,India,1991,1994,37,36,12,12,12,0,0,2
RMH Binny ,India,1980,1987,72,70,12,12,12,0,0,2
IR Bishop ,West Indies,1988,1997,84,83,12,12,12,0,0,1
DE Bollinger ,Australia,2009,2011,39,39,12,12,12,0,0,1
JM Brearley ,England,1977,1980,25,25,12,12,12,0,0,2
C Carter ,Hong Kong,2015,2018,11,11,12,10,1,9,2,3
CD Collymore ,West Indies,1999,2007,84,83,12,12,12,0,0,2
KM Dabengwa ,Zimbabwe,2005,2010,37,37,12,12,12,0,0,2
JWM Dalrymple ,England,2006,2007,27,27,12,12,12,0,0,2
KSC de Silva ,Sri Lanka,1996,2000,38,37,12,12,12,0,0,2
J Dyson ,Australia,1980,1983,29,29,12,12,12,0,0,3
BA Edgar ,New Zealand,1978,1986,64,63,12,12,12,0,0,2
CN Evans ,Zimbabwe,1992,2002,53,52,12,12,12,0,0,2
NA Foster ,England,1984,1989,48,48,12,12,12,0,0,2
MJ Horne ,New Zealand,1997,2002,50,49,12,12,12,0,0,2
Imad Wasim ,Pakistan,2015,2020,55,54,12,12,12,0,0,1
CA Ingram ,South Africa,2010,2013,31,31,12,12,12,0,0,2
Javed Omar ,BAN,1995,2007,59,59,12,12,12,0,0,2
LM Jongwe ,Zimbabwe,2014,2024,43,41,12,12,12,0,0,3
SG Law ,Australia,1994,1999,54,54,12,12,12,0,0,2
DA Marillier ,Zimbabwe,2000,2003,48,48,12,12,12,0,0,2
XM Marshall (USA/WI),NA,2005,2020,37,36,12,12,12,0,0,2
T Maruma ,Zimbabwe,2007,2021,22,22,12,12,12,0,0,3
SF Mire ,Zimbabwe,2014,2019,47,47,12,12,12,0,0,1
HS Modi ,Kenya,1996,2006,63,63,12,12,12,0,0,2
J Mubarak ,Sri Lanka,2002,2013,40,40,12,12,12,0,0,2
TK Musakanda ,Zimbabwe,2016,2022,16,16,12,12,12,0,0,2
Nadeem Ahmed ,Hong Kong,2004,2018,25,25,12,12,12,0,0,2
MP O'Dowd ,NED,2019,2024,54,54,12,12,12,0,0,2
MO Odumbe ,Kenya,1996,2003,61,61,12,12,12,0,0,2
JM Parker ,New Zealand,1974,1981,24,24,12,11,11,0,1,3
DA Reeve ,England,1991,1996,29,29,12,12,12,0,0,3
JA Rennie ,Zimbabwe,1993,2000,44,44,12,12,12,0,0,2
Shaiman Anwar ,United Arab Emirates,2014,2019,40,40,12,12,12,0,0,2
RE van der Merwe (NED/SA),NA,2009,2024,31,31,12,12,12,0,0,2
C White ,England,1994,2003,51,50,12,12,12,0,0,1
CJ Anderson ,New Zealand,2013,2017,49,48,11,11,11,0,0,2
Babar Hayat ,Hong Kong,2014,2018,22,22,11,11,11,0,0,2
L Balaji ,India,2002,2009,30,30,11,11,11,0,0,2
D Bau ,Papau New Guinea,2016,2022,14,14,11,8,1,7,3,3
AM Blignaut ,Zimbabwe,1999,2010,54,54,11,11,11,0,0,2
AC Botha ,Ireland,2006,2011,42,40,11,11,11,0,0,2
EA Brandes ,Zimbabwe,1987,1999,59,59,11,11,11,0,0,1
CR Brathwaite ,West Indies,2011,2019,44,42,11,11,11,0,0,1
R Clarke ,England,2003,2006,20,20,11,11,11,0,0,3
RDB Croft ,England,1996,2001,50,49,11,11,11,0,0,1
AC Dale ,Australia,1997,2000,30,30,11,11,11,0,0,1
A Dutt ,NED,2021,2024,46,46,11,11,11,0,0,2
J Edness ,BER,2007,2008,11,11,11,7,0,7,4,3
D Ganga ,West Indies,1999,2006,35,35,11,11,11,0,0,2
Haris Rauf ,Pakistan,2020,2024,40,40,11,11,11,0,0,2
DW Hookes ,Australia,1977,1986,39,37,11,11,11,0,0,2
Ibrahim Zadran ,Afghanistan,2019,2024,33,33,11,11,11,0,0,1
KM Jarvis ,Zimbabwe,2009,2019,49,49,11,11,11,0,0,2
Javed Ahmadi ,Afghanistan,2010,2021,47,44,11,11,11,0,0,1
Karan KC ,NEP,2018,2024,57,57,11,11,11,0,0,2
PN Kirsten ,South Africa,1991,1994,40,40,11,11,11,0,0,2
P Kumar ,India,2007,2012,68,67,11,11,11,0,0,2
CK Langeveldt ,South Africa,2001,2010,72,71,11,11,11,0,0,1
RT Latham ,New Zealand,1990,1994,33,33,11,11,11,0,0,2
DJ Malan ,England,2019,2023,30,30,11,11,11,0,0,2
JN Malan ,South Africa,2020,2022,23,22,11,11,11,0,0,3
JS Malhotra ,United States of America,2019,2022,18,18,11,10,4,6,1,2
WP Masakadza ,Zimbabwe,2015,2024,38,37,11,11,11,0,0,2
Mohammad Irfan ,Pakistan,2010,2016,60,60,11,11,11,0,0,2
CB Mpofu ,Zimbabwe,2004,2020,84,83,11,11,11,0,0,1
Muhammad Usman ,United Arab Emirates,2016,2022,38,38,11,11,11,0,0,3
Mujeeb Ur Rahman ,Afghanistan,2017,2023,75,74,11,11,11,0,0,1
BA Murphy ,Zimbabwe,2000,2003,31,31,11,11,11,0,0,2
D Murphy ,Scotland,2013,2013,8,8,11,8,0,8,3,5
P Mustard ,England,2007,2008,10,10,11,9,0,9,2,2
F Mutizwa ,Zimbabwe,2009,2011,17,17,11,9,1,8,2,3
RJ Nicol ,New Zealand,2011,2013,22,22,11,11,11,0,0,2
SB O'Connor ,New Zealand,1997,2000,38,38,11,11,11,0,0,2
H Osinde ,Canada,2006,2013,42,41,11,11,11,0,0,2
MM Patel ,India,2006,2011,70,68,11,11,11,0,0,2
SM Patil ,India,1980,1986,45,44,11,11,11,0,0,2
SP Patil ,United Arab Emirates,2014,2015,13,13,11,8,0,8,3,3
D Pretorius ,South Africa,2016,2022,27,26,11,11,11,0,0,2
DR Pringle ,England,1982,1993,44,44,11,11,11,0,0,2
CPH Ramanayake ,Sri Lanka,1986,1995,62,62,11,11,11,0,0,2
RJ Ratnayake ,Sri Lanka,1982,1993,70,70,11,11,11,0,0,2
SJ Rhodes ,England,1989,1995,9,9,11,9,0,9,2,4
SJ Rixon ,Australia,1978,1985,6,6,11,9,0,9,2,4
JA Rudolph (Afr/SA),NA,2003,2006,45,45,11,11,11,0,0,2
AD Russell ,West Indies,2011,2019,56,56,11,11,11,0,0,1
SV Samson ,India,2021,2023,16,16,11,9,1,8,2,3
Sanuar Hossain ,BAN,1998,2003,27,27,11,11,11,0,0,2
Shaheen Shah Afridi ,Pakistan,2018,2024,56,55,11,11,11,0,0,1
MA Suji ,Kenya,1996,2006,64,64,11,11,11,0,0,2
Tahir Naqqash ,Pakistan,1980,1985,40,38,11,11,11,0,0,2
Taskin Ahmed ,BAN,2014,2024,75,73,11,11,11,0,0,1
H Thaker ,Canada,2023,2024,20,20,11,11,11,0,0,2
DLS van Bunge ,NED,2002,2013,37,37,11,11,11,0,0,2
MN van Wyk ,South Africa,2003,2015,17,17,11,10,1,9,1,4
K Verreynne ,South Africa,2020,2024,17,17,11,10,8,2,1,3
PA Wallace ,West Indies,1991,2000,33,32,11,11,11,0,0,2
MR Whitney ,Australia,1983,1993,38,38,11,11,11,0,0,3
AC Agar ,Australia,2015,2023,22,22,10,10,10,0,0,2
FA Allen ,West Indies,2018,2022,20,19,10,10,10,0,0,2
Amir Hamza ,Afghanistan,2012,2017,31,31,10,10,10,0,0,2
SD Anurasiri ,Sri Lanka,1986,1994,45,45,10,10,10,0,0,2
Arshad Khan ,Pakistan,1993,2006,58,57,10,10,10,0,0,2
SK Atai ,Papau New Guinea,2019,2022,15,15,10,9,0,9,1,2
SFAF Bacchus ,West Indies,1978,1983,29,29,10,10,10,0,0,2
BC Broad ,England,1987,1988,34,34,10,10,10,0,0,1
RK Chauhan ,India,1993,1997,35,34,10,10,10,0,0,1
Chirag Suri ,United Arab Emirates,2018,2023,37,37,10,10,10,0,0,1
DT Christian ,Australia,2012,2021,20,20,10,10,10,0,0,2
SR Clark ,Australia,2005,2009,39,39,10,10,10,0,0,2
JH Davey ,Scotland,2010,2019,31,30,10,10,10,0,0,2
SB Doull ,New Zealand,1992,2000,42,42,10,10,10,0,0,2
Faheem Ashraf ,Pakistan,2017,2023,34,33,10,10,10,0,0,2
Fawad Alam ,Pakistan,2007,2015,38,38,10,10,10,0,0,2
JN Gillespie ,Australia,1996,2005,97,97,10,10,10,0,0,1
CN Greaves ,Scotland,2022,2024,29,29,10,10,10,0,0,2
J Gumbie ,Zimbabwe,2023,2024,12,11,10,10,0,10,0,3
DAS Gunaratne ,Sri Lanka,2016,2019,31,30,10,10,10,0,0,2
RM Haq ,Scotland,2006,2015,54,52,10,10,10,0,0,2
SJ Harmison ,England,2002,2009,58,58,10,10,10,0,0,1
BW Hilfenhaus ,Australia,2007,2012,25,25,10,10,10,0,0,2
TG Hogan ,Australia,1983,1984,16,15,10,10,10,0,0,2
Iftikhar Anjum ,Pakistan,2004,2010,62,61,10,10,10,0,0,3
Ihsanullah ,Afghanistan,2017,2018,16,16,10,10,10,0,0,3
A Johnson ,Canada,2023,2024,20,20,10,10,10,0,0,2
Kaleemullah ,OMA,2019,2024,46,46,10,10,10,0,0,2
M Kartik ,India,2002,2007,37,37,10,10,10,0,0,1
R Lamba ,India,1986,1989,32,32,10,10,10,0,0,1
RDM Leverock ,BER,2006,2009,32,32,10,10,10,0,0,2
DK Lillee ,Australia,1972,1983,63,63,10,10,10,0,0,2
DR Lockhart ,Scotland,2006,2010,14,14,10,10,1,9,0,3
CR Matthews ,South Africa,1991,1997,56,55,10,10,10,0,0,2
KR Mayers ,West Indies,2021,2023,28,28,10,10,10,0,0,2
KP Meiyappan ,United Arab Emirates,2019,2023,31,31,10,10,10,0,0,3
Mohammad Salman ,Pakistan,2011,2011,7,7,10,8,0,8,2,4
DS Mohanty ,India,1997,2001,45,44,10,10,10,0,0,2
A Nao ,Papau New Guinea,2017,2023,26,26,10,10,10,0,0,2
Nurul Hasan ,BAN,2016,2023,7,7,10,6,0,6,4,3
MK Pandey ,India,2015,2021,29,29,10,10,10,0,0,1
Saleem Elahi ,Pakistan,1995,2004,48,47,10,10,10,0,0,2
PD Salt ,England,2021,2024,27,26,10,10,9,1,0,2
A Saud ,NEP,2022,2024,11,11,10,8,0,8,2,3
Shabbir Ahmed ,Pakistan,1999,2005,32,32,10,10,10,0,0,2
A Sharafu ,United Arab Emirates,2021,2024,19,19,10,10,10,0,0,2
A Sharma ,United Arab Emirates,2023,2024,13,13,10,10,0,10,0,3
Sohaib Maqsood ,Pakistan,2013,2021,29,29,10,10,10,0,0,2
Tauseef Ahmed ,Pakistan,1982,1990,70,68,10,10,10,0,0,1
M Theekshana ,Sri Lanka,2021,2024,48,48,10,10,10,0,0,1
KL Tucker ,BER,2006,2007,12,12,10,9,1,8,1,4
JM Vince ,England,2015,2023,25,25,10,10,10,0,0,2
AC Waller ,Zimbabwe,1987,1997,39,38,10,10,10,0,0,2
KD Walters ,Australia,1971,1981,28,28,10,10,10,0,0,3
CAK Walton ,West Indies,2009,2017,9,9,10,9,3,6,1,4
DN Wellalage ,Sri Lanka,2022,2024,27,27,10,10,10,0,0,2
MH Yardy ,England,2006,2011,28,28,10,10,10,0,0,2
Yashpal Sharma ,India,1978,1985,42,42,10,10,10,0,0,1
CN Ackermann ,NED,2021,2024,18,18,9,9,9,0,0,2
FH Allen ,New Zealand,2022,2023,22,21,9,9,9,0,0,2
HS Baidwan ,Canada,2008,2014,32,32,9,9,9,0,0,1
HMCM Bandara ,Sri Lanka,2006,2010,31,30,9,9,9,0,0,3
SJ Benn ,West Indies,2008,2016,47,46,9,9,9,0,0,1
MG Bracewell ,New Zealand,2022,2024,22,21,9,9,9,0,0,1
NT Broom ,New Zealand,2009,2017,39,39,9,9,9,0,0,2
AR Caddick ,England,1993,2003,54,53,9,9,9,0,0,2
LOB Cann ,BER,2006,2009,26,26,9,9,9,0,0,2
PP Chawla ,India,2007,2011,25,25,9,9,9,0,0,3
SM Curran ,England,2018,2024,35,35,9,9,9,0,0,1
GJ Delany ,Ireland,2020,2023,21,21,9,9,9,0,0,2
N Deonarine ,West Indies,2005,2015,31,31,9,9,9,0,0,2
SI de Saram ,Sri Lanka,1999,2001,15,15,9,9,9,0,0,2
MA Ealham ,England,1996,2001,64,63,9,9,9,0,0,1
S Elworthy ,South Africa,1998,2002,39,38,9,9,9,0,0,3
SA Engelbrecht ,NED,2023,2024,12,12,9,9,9,0,0,2
AC Evans ,Scotland,2009,2023,42,40,9,9,9,0,0,1
Gulsan Jha ,NEP,2021,2024,34,33,9,9,9,0,0,2
Jasdeep Singh ,United States of America,2019,2024,35,35,9,9,9,0,0,2
IA Karim ,Kenya,2011,2014,9,9,9,8,3,5,1,2
D Khanal ,NEP,2022,2024,14,14,9,9,9,0,0,2
NR Kirton ,Canada,2023,2024,18,18,9,9,9,0,0,2
CM Kuggeleijn ,New Zealand,1988,1989,16,16,9,9,9,0,0,2
S Lamichhane ,NEP,2018,2024,58,57,9,9,9,0,0,1
T Lungameni ,Namibia,2022,2024,31,31,9,9,9,0,0,2
NC McGarrell ,West Indies,1998,2001,17,17,9,9,9,0,0,2
W Madhevere ,Zimbabwe,2020,2023,36,36,9,9,9,0,0,1
KA Maharaj ,South Africa,2017,2023,44,43,9,9,9,0,0,2
RD McCann ,Ireland,2010,2010,8,8,9,9,0,9,0,3
SS McKechnie ,Hong Kong,2017,2018,8,8,9,8,1,7,1,4
Mohammad Wasim ,Pakistan,1996,2000,25,25,9,9,9,0,0,2
CH Morris ,South Africa,2013,2019,42,40,9,9,9,0,0,1
T Mupariwa ,Zimbabwe,2004,2016,40,40,9,9,9,0,0,1
Nizakat Khan ,Hong Kong,2014,2018,20,20,9,9,9,0,0,2
SJ Palframan ,South Africa,1996,1996,7,7,9,9,0,9,0,3
T Panyangara ,Zimbabwe,2004,2016,65,65,9,9,9,0,0,2
BP Patterson ,West Indies,1986,1993,59,58,9,9,9,0,0,1
AD Poynter ,Ireland,2008,2014,19,18,9,9,9,0,0,2
Rajin Saleh ,BAN,2003,2006,43,43,9,9,9,0,0,2
GM Ritchie ,Australia,1982,1987,44,44,9,9,9,0,0,2
CP Rizwan ,United Arab Emirates,2019,2024,42,42,9,9,9,0,0,1
AM Samad ,Canada,2003,2009,27,26,9,9,9,0,0,2
S Samarawickrama ,Sri Lanka,2017,2024,50,50,9,9,8,1,0,2
JA Simpson ,England,2021,2021,3,3,9,9,0,9,0,5
MJ Slater ,Australia,1993,1997,42,42,9,9,9,0,0,2
RS Sodhi ,India,2000,2002,18,18,9,9,9,0,0,2
Sohrawordi Shuvo ,BAN,2010,2011,17,17,9,9,9,0,0,2
CB Sole ,Scotland,2016,2024,31,31,9,9,9,0,0,3
Taufeeq Umar ,Pakistan,2001,2011,22,22,9,9,9,0,0,1
SN Thakur ,India,2017,2023,47,46,9,9,9,0,0,1
JR Thomson ,Australia,1975,1985,50,50,9,9,9,0,0,2
LL Tsotsobe ,South Africa,2009,2013,61,60,9,9,9,0,0,2
JJ Tucker ,BER,2006,2009,26,26,9,9,9,0,0,2
JNT Vare ,Papau New Guinea,2014,2018,9,9,9,6,0,6,3,3
M Vijay ,India,2010,2015,17,17,9,9,9,0,0,2
W Watson ,New Zealand,1986,1994,61,61,9,9,9,0,0,1
AR Adams ,New Zealand,2001,2007,42,41,8,8,8,0,0,2
Akram Khan ,BAN,1988,2003,44,44,8,8,8,0,0,2
Amjad Javed ,United Arab Emirates,2008,2017,15,15,8,8,8,0,0,1
Aryan Lakra ,United Arab Emirates,2022,2023,16,16,8,8,8,0,0,2
Azhar Ali ,Pakistan,2011,2018,53,52,8,8,8,0,0,1
K Birkenstock ,Namibia,2019,2023,20,20,8,8,8,0,0,2
ID Blackwell ,England,2002,2006,34,34,8,8,8,0,0,2
JAR Blain ,Scotland,1999,2009,33,32,8,8,8,0,0,1
DE Budge ,Scotland,2018,2022,17,16,8,8,8,0,0,2
MG Burgess ,New Zealand,1973,1981,26,26,8,8,8,0,0,2
IG Butler ,New Zealand,2002,2010,26,25,8,8,8,0,0,2
PVD Chameera ,Sri Lanka,2015,2024,52,51,8,8,8,0,0,1
TM Chappell ,Australia,1980,1983,20,20,8,8,8,0,0,2
TL Chatara ,Zimbabwe,2013,2023,87,87,8,8,8,0,0,1
FRJ Coleman ,Scotland,2013,2015,16,15,8,8,8,0,0,3
PT Collins ,West Indies,1999,2005,30,30,8,8,8,0,0,2
Z Crawley ,England,2021,2023,8,7,8,8,8,0,0,3
NRJ Croes ,NED,2023,2024,13,13,8,8,8,0,0,2
MD Dai ,Papau New Guinea,2014,2018,18,18,8,8,8,0,0,2
SM Davies ,England,2009,2011,8,8,8,8,0,8,0,2
S Dhaniram ,Canada,2006,2010,44,43,8,8,8,0,0,1
Enamul Haque jnr ,BAN,2005,2009,10,10,8,8,8,0,0,2
Fayyaz Butt ,OMA,2019,2024,30,30,8,8,8,0,0,1
ADS Fletcher ,West Indies,2008,2016,25,25,8,5,3,2,3,3
Hannan Sarkar ,BAN,2002,2004,20,20,8,8,6,2,0,2
RM Hogg ,Australia,1979,1985,71,69,8,8,8,0,0,1
RIC Holder ,West Indies,1993,1997,37,37,8,8,8,0,0,3
RK Illingworth ,England,1991,1996,25,25,8,8,8,0,0,2
BP Julian ,Australia,1993,1999,25,25,8,8,8,0,0,2
Junaid Khan ,Pakistan,2011,2019,76,76,8,8,8,0,0,1
AI Kallicharran ,West Indies,1973,1981,31,31,8,8,8,0,0,2
SC Khanna ,India,1979,1984,10,9,8,4,0,4,4,3
GF Labrooy ,Sri Lanka,1986,1992,44,44,8,8,8,0,0,1
D la Cock ,Namibia,2022,2022,16,16,8,8,8,0,0,1
W Larkins ,England,1979,1991,25,25,8,8,8,0,0,1
NAM McLean ,West Indies,1996,2003,45,45,8,8,8,0,0,2
C Madande ,Zimbabwe,2022,2024,15,14,8,7,0,7,1,2
GT Main ,Scotland,2019,2024,16,16,8,8,8,0,0,2
Manjural Islam ,BAN,1999,2003,34,34,8,8,8,0,0,1
VJ Marks ,England,1980,1988,34,34,8,8,8,0,0,1
Mirwais Ashraf ,Afghanistan,2009,2016,46,45,8,8,8,0,0,2
Mohammad Akram ,Pakistan,1995,2000,23,21,8,8,8,0,0,2
Mohammad Amir ,Pakistan,2009,2019,61,60,8,8,8,0,0,2
G Motie ,West Indies,2022,2024,19,19,8,8,8,0,0,2
S Mukuddem ,BER,2006,2007,20,20,8,8,8,0,0,1
AD Mullally ,England,1996,2001,50,49,8,8,8,0,0,2
AT Nidamanuru ,NED,2022,2024,31,31,8,8,8,0,0,1
CM Old ,England,1973,1981,32,32,8,8,8,0,0,2
DR Parry ,West Indies,1978,1980,6,6,8,8,8,0,0,2
KR Pushpakumara ,Sri Lanka,1994,1999,31,31,8,8,8,0,0,3
EC Rainsford ,Zimbabwe,2004,2010,39,39,8,8,8,0,0,2
LN Rajbanshi ,NEP,2019,2024,34,33,8,8,8,0,0,3
SLV Raju ,India,1990,1996,53,52,8,8,8,0,0,1
MR Ramprakash ,England,1991,2001,18,18,8,8,8,0,0,2
RD Rickelton ,South Africa,2023,2024,5,5,8,6,1,5,2,3
MJR Rindel ,South Africa,1994,1999,22,22,8,8,8,0,0,2
IH Romaine ,BER,2006,2009,35,35,8,8,8,0,0,2
PADLR Sandakan ,Sri Lanka,2016,2021,31,31,8,8,8,0,0,2
Sarfraz Nawaz ,Pakistan,1973,1984,45,45,8,8,8,0,0,1
TL Seifert ,New Zealand,2019,2019,3,3,8,7,0,7,1,4
Shafiul Islam ,BAN,2010,2020,60,60,8,8,8,0,0,2
T Shamsi ,South Africa,2016,2023,51,49,8,8,8,0,0,2
SB Smith ,Australia,1983,1985,28,27,8,8,8,0,0,1
Syed Rasel ,BAN,2005,2010,52,52,8,8,8,0,0,2
SW Tait ,Australia,2007,2011,35,35,8,8,8,0,0,2
Tapash Baisya ,BAN,2002,2007,56,56,8,8,8,0,0,1
SR Thompson ,Ireland,2013,2017,20,19,8,8,8,0,0,1
Towhid Hridoy ,BAN,2023,2024,33,32,8,8,8,0,0,2
MRJ Veletta ,Australia,1987,1989,20,20,8,8,7,1,0,3
DM Wellham ,Australia,1981,1987,17,17,8,8,8,0,0,2
LR Williams ,West Indies,1996,2001,15,15,8,8,8,0,0,2
KJ Wright ,Australia,1979,1979,5,5,8,8,0,8,0,2
KJ Abbott ,South Africa,2013,2016,28,27,7,7,7,0,0,2
Abdur Rehman ,Pakistan,2006,2014,31,31,7,7,7,0,0,2
PR Adams ,South Africa,1996,2003,24,24,7,7,7,0,0,2
Al Sahariar ,BAN,1999,2003,29,29,7,7,7,0,0,2
Aqib Ilyas ,OMA,2019,2024,32,32,7,7,7,0,0,2
JC Archer ,England,2019,2024,27,27,7,7,7,0,0,1
Asif Iqbal ,Pakistan,1973,1979,10,10,7,7,7,0,0,2
Asif Khan ,United Arab Emirates,2022,2024,35,35,7,7,7,0,0,2
KBJ Azad ,India,1980,1986,25,24,7,7,7,0,0,2
GEF Barnett ,Canada,2006,2010,22,22,7,7,7,0,0,1
DE Bernard ,West Indies,2003,2010,20,19,7,7,7,0,0,1
IS Billcliff ,Canada,2003,2009,19,19,7,7,7,0,0,2
D Bishoo ,West Indies,2011,2019,42,41,7,7,7,0,0,1
GS Blewett ,Australia,1995,1999,32,32,7,7,7,0,0,2
JL Carter ,West Indies,2015,2019,33,32,7,7,7,0,0,2
NM Coulter-Nile ,Australia,2013,2019,32,32,7,7,7,0,0,1
CD de Lange ,Scotland,2016,2017,13,13,7,7,7,0,0,3
TBM de Leede ,NED,1996,2007,29,29,7,7,7,0,0,2
JL Denly ,England,2009,2020,16,16,7,7,7,0,0,2
NS Dhaliwal ,Canada,2024,2024,11,11,7,7,7,0,0,2
AIC Dodemaide ,Australia,1988,1993,24,24,7,7,7,0,0,2
B Evans ,Zimbabwe,2022,2023,15,14,7,7,7,0,0,1
CJ Ferguson ,Australia,2009,2011,30,29,7,7,7,0,0,2
N Pradeep ,Sri Lanka,2012,2022,49,48,7,7,7,0,0,2
SR Gillespie ,New Zealand,1986,1988,19,19,7,7,7,0,0,2
G Goudie ,Scotland,2008,2013,16,16,7,7,7,0,0,2
AW Greig ,England,1972,1977,22,21,7,7,7,0,0,3
R Gunasekera ,Canada,2008,2014,19,19,7,7,7,0,0,2
GM Hamilton ,Scotland,1999,2010,38,38,7,6,6,0,1,1
AS Hansra ,Canada,2010,2014,24,24,7,7,7,0,0,1
MN Hart ,New Zealand,1994,2002,13,13,7,7,7,0,0,2
DL Hemp ,BER,2006,2009,22,22,7,7,7,0,0,3
AG Huckle ,Zimbabwe,1997,1999,19,19,7,7,7,0,0,2
Humayun Farhat ,Pakistan,2001,2001,5,5,7,4,0,4,3,3
KAD Hurdle ,BER,2006,2007,19,19,7,7,7,0,0,1
Jahurul Islam ,BAN,2010,2013,14,14,7,7,3,4,0,3
NG Jones ,Ireland,2010,2011,14,14,7,7,7,0,0,2
S Randiv ,Sri Lanka,2009,2016,31,30,7,7,7,0,0,1
SHT Kandamby ,Sri Lanka,2004,2014,39,38,7,7,7,0,0,2
P Khadka ,NEP,2018,2020,10,10,7,7,7,0,0,3
NR Kumar ,Canada,2010,2014,16,16,7,7,7,0,0,2
RN Lewis ,West Indies,1997,2009,28,28,7,7,7,0,0,1
NM Lyon ,Australia,2012,2019,29,29,7,7,7,0,0,2
PD McGlashan ,New Zealand,2009,2009,4,4,7,7,0,7,0,3
CJ McKay ,Australia,2009,2014,59,59,7,7,7,0,0,3
CS Martin ,New Zealand,2001,2008,20,19,7,7,7,0,0,1
SW Masakadza ,Zimbabwe,2010,2014,16,16,7,7,7,0,0,3
Mehrab Hossain jnr ,BAN,2006,2009,18,18,7,7,7,0,0,1
Mohammad Haris ,Pakistan,2022,2023,6,6,7,5,2,3,2,3
Mohammad Mithun ,BAN,2014,2021,34,34,7,7,7,0,0,2
VV Morea ,Papau New Guinea,2014,2018,13,13,7,7,7,0,0,2
PWA Mulder ,South Africa,2017,2024,20,20,7,7,7,0,0,2
CT Mutombodzi ,Zimbabwe,2013,2020,14,14,7,7,7,0,0,3
Naimur Rahman ,BAN,1995,2002,29,29,7,7,7,0,0,2
R Ngarava ,Zimbabwe,2017,2024,44,42,7,7,7,0,0,1
J Nyumbu ,Zimbabwe,2014,2015,19,19,7,7,7,0,0,2
NN Odhiambo ,Kenya,2006,2014,69,69,7,7,7,0,0,1
PP Ojha ,India,2008,2012,18,18,7,7,7,0,0,3
E Otieno ,Kenya,2007,2014,26,26,7,7,7,0,0,2
BJ Patel ,Kenya,2001,2006,31,31,7,7,7,0,0,1
H Patel ,Canada,2009,2013,23,22,7,7,7,0,0,2
NK Patel ,United States of America,2019,2023,41,41,7,7,7,0,0,1
SR Patel ,England,2008,2013,36,36,7,7,7,0,0,2
N Pokana ,Papau New Guinea,2017,2022,21,21,7,7,7,0,0,3
NS Poonia ,Scotland,2006,2009,21,20,7,7,7,0,0,2
S Prasanna ,Sri Lanka,2011,2019,40,40,7,7,7,0,0,1
C Pringle ,New Zealand,1990,1995,64,64,7,7,7,0,0,1
SMA Priyanjan ,Sri Lanka,2013,2015,23,23,7,7,7,0,0,1
DJ Reekers ,NED,2006,2009,19,19,7,7,7,0,0,2
KW Richardson ,Australia,2013,2020,25,25,7,7,7,0,0,2
BG Rogers ,Zimbabwe,2002,2005,15,15,7,7,7,0,0,1
AK Sah ,NEP,2018,2024,16,15,7,7,4,3,0,2
V Shankar ,India,2019,2019,12,12,7,7,7,0,0,1
Shariz Ahmad ,NED,2022,2024,20,20,7,7,7,0,0,2
B Sharki ,NEP,2022,2024,28,28,7,7,7,0,0,1
C Sharma ,India,1983,1994,65,64,7,7,7,0,0,1
SK Sharma ,India,1988,1990,23,23,7,7,7,0,0,2
M Sheikh ,Kenya,1997,2000,21,21,7,7,7,0,0,1
L Sivaramakrishnan ,India,1985,1987,16,16,7,7,7,0,0,3
GC Small ,England,1987,1992,53,53,7,7,7,0,0,2
JL Smith ,England,2023,2024,7,6,7,7,0,7,0,2
RP Snell ,South Africa,1991,1996,42,42,7,7,7,0,0,1
Sohag Gazi ,BAN,2012,2014,20,20,7,7,7,0,0,2
TB Sole ,Scotland,2018,2019,10,10,7,7,7,0,0,2
S Sreesanth ,India,2005,2011,53,52,7,7,7,0,0,1
WF Stelling ,NED,2006,2007,15,15,7,7,7,0,0,1
ES Szwarczynski ,NED,2006,2014,41,41,7,7,7,0,0,1
CJ Tavare ,England,1980,1984,29,29,7,7,7,0,0,2
JWA Taylor ,England,2011,2015,27,27,7,7,7,0,0,3
J Theron (SA/USA),NA,2010,2022,18,18,7,7,7,0,0,2
G Toka ,Papau New Guinea,2019,2023,22,22,7,7,7,0,0,2
RJW Topley ,England,2015,2024,30,30,7,7,7,0,0,2
Usama Mir ,Pakistan,2023,2023,12,12,7,7,7,0,0,2
HGV Vare ,Papau New Guinea,2023,2023,6,6,7,7,0,7,0,3
Vikramjit Singh ,NED,2022,2024,40,40,7,7,7,0,0,2
AC Voges ,Australia,2007,2013,31,31,7,7,7,0,0,2
DF Watts ,Scotland,2006,2011,36,35,7,7,7,0,0,2
VJ Wells ,England,1999,1999,9,9,7,7,7,0,0,3
HN Ya France ,Namibia,2019,2023,25,25,7,7,7,0,0,2
Aftab Alam ,Afghanistan,2010,2019,27,27,6,6,6,0,0,2
Ashfaq Ahmed ,United Arab Emirates,2018,2019,16,16,6,6,6,0,0,2
Asif Ali ,Pakistan,2018,2022,21,20,6,6,6,0,0,1
A Athanaze ,West Indies,2023,2024,12,12,6,6,6,0,0,2
PS Athavale ,OMA,2024,2024,7,7,6,6,0,6,0,2
Azmatullah Omarzai ,Afghanistan,2021,2024,33,33,6,6,6,0,0,1
M Bhanuka ,Sri Lanka,2019,2021,6,6,6,5,0,5,1,3
IDR Bradshaw ,West Indies,2004,2007,62,62,6,6,6,0,0,1
JP Bray ,Ireland,2006,2007,15,15,6,6,5,1,0,2
AD Brown ,England,1996,2001,16,16,6,6,6,0,0,2
DG Brownlie ,New Zealand,2012,2017,16,16,6,6,6,0,0,1
Mudassar Bukhari ,NED,2007,2014,46,46,6,6,6,0,0,1
LJ Burger ,Namibia,2003,2003,6,6,6,6,6,0,0,3
DJ Callaghan ,South Africa,1992,2000,29,28,6,6,6,0,0,2
DJ Capel ,England,1987,1990,23,23,6,6,6,0,0,2
BA Carse ,England,2021,2024,19,18,6,6,6,0,0,2
S Chattergoon ,West Indies,2006,2009,18,17,6,6,6,0,0,2
TS Chisoro ,Zimbabwe,2015,2020,21,20,6,6,6,0,0,2
GR Codrington ,Canada,2006,2007,17,17,6,6,6,0,0,1
DG Cork ,England,1992,2002,32,32,6,6,6,0,0,2
CD Cumming ,New Zealand,2003,2009,13,13,6,6,6,0,0,2
WM Darling ,Australia,1978,1982,18,17,6,6,6,0,0,3
N Davin ,Namibia,2023,2024,9,9,6,6,6,0,0,3
TN de Grooth ,NED,2006,2013,34,34,6,6,6,0,0,1
AM de Silva ,Sri Lanka,1986,1993,4,4,6,4,0,4,2,3
EAR de Silva ,Sri Lanka,1986,1992,28,28,6,6,6,0,0,2
T Duffin ,Zimbabwe,2006,2007,23,23,6,6,6,0,0,1
PH Edmonds ,England,1977,1987,29,29,6,6,6,0,0,2
Enamul Haque ,BAN,1990,2002,29,29,6,6,6,0,0,3
G Fowler ,England,1983,1986,26,26,6,4,2,2,2,3
AD Gaekwad ,India,1975,1987,15,14,6,6,6,0,0,1
MR Gillespie ,New Zealand,2006,2009,32,31,6,6,6,0,0,2
K Gore ,United States of America,2019,2021,16,16,6,6,6,0,0,3
Hammad Mirza ,OMA,2024,2024,4,4,6,4,0,4,2,3
Hamza Tariq ,Canada,2011,2014,7,7,6,5,0,5,1,2
RJ Harris ,Australia,2009,2012,21,21,6,6,6,0,0,1
Harvinder Singh ,India,1997,2001,16,16,6,6,6,0,0,1
Hasibul Hossain ,BAN,1995,2004,32,32,6,6,6,0,0,2
UC Hathurusingha ,Sri Lanka,1992,1999,35,35,6,6,6,0,0,1
R Hekure ,Papau New Guinea,2019,2023,25,25,6,6,6,0,0,2
MC Henriques ,Australia,2009,2021,16,16,6,6,6,0,0,2
VA Holder ,West Indies,1973,1978,12,12,6,6,6,0,0,1
IG Holland ,United States of America,2019,2022,15,15,6,6,6,0,0,2
BC Hollioake ,England,1997,2002,20,20,6,6,6,0,0,1
MG Hughes ,Australia,1988,1993,33,33,6,6,6,0,0,1
Imtiaz Abbasi ,United Arab Emirates,1994,1996,7,7,6,4,0,4,2,2
RC Irani ,England,1996,2003,31,31,6,6,6,0,0,1
WG Jacks ,England,2023,2024,15,14,6,6,6,0,0,2
WR James ,Zimbabwe,1992,1996,11,11,6,6,3,3,0,2
M Jansen ,South Africa,2022,2023,23,23,6,6,6,0,0,2
TP Kamungozi ,Zimbabwe,2006,2015,14,14,6,6,6,0,0,2
AY Karim ,Kenya,1996,2003,34,34,6,6,6,0,0,1
Karim Sadiq ,Afghanistan,2009,2016,24,24,6,6,6,0,0,2
C Karunaratne ,Sri Lanka,2021,2023,26,25,6,6,6,0,0,1
Khurram Khan ,United Arab Emirates,2004,2015,16,16,6,6,6,0,0,2
Khushdil Shah ,Pakistan,2020,2022,10,10,6,6,6,0,0,2
CL King ,West Indies,1976,1980,18,18,6,6,6,0,0,1
VJ Kingma ,NED,2014,2024,26,26,6,6,6,0,0,1
CBRLS Kumara ,Sri Lanka,2017,2024,31,31,6,6,6,0,0,2
Kushal Malla ,NEP,2020,2024,39,39,6,6,6,0,0,2
JK Lever ,England,1976,1982,22,22,6,6,6,0,0,2
DK Liyanage ,Sri Lanka,1992,2001,16,16,6,6,6,0,0,2
D Madushanka ,Sri Lanka,2023,2024,26,26,6,6,6,0,0,1
NB Mahwire ,Zimbabwe,2004,2006,23,23,6,6,6,0,0,2
Manjural Islam Rana ,BAN,2003,2006,25,25,6,6,6,0,0,1
JJ Martin ,India,1999,2001,10,10,6,6,6,0,0,3
Mehrab Hossain ,BAN,1998,2003,18,18,6,6,6,0,0,2
Mohammad Nadeem ,OMA,2019,2024,38,38,6,6,6,0,0,1
Mohammad Naveed ,United Arab Emirates,2014,2019,39,39,6,6,6,0,0,1
Mohammed Siraj ,India,2019,2024,44,43,6,6,6,0,0,2
JFM Morrison ,New Zealand,1975,1983,18,18,6,6,6,0,0,2
SR Mukkamalla ,United States of America,2022,2024,25,25,6,6,6,0,0,1
Mushfiqur Rahman ,BAN,2000,2004,28,28,6,6,6,0,0,1
MV Nagamootoo ,West Indies,2000,2002,24,24,6,6,6,0,0,1
Nazmul Hossain ,BAN,2004,2012,38,38,6,6,6,0,0,1
JO Ngoche ,Kenya,2010,2013,17,17,6,6,6,0,0,1
ML Nkala ,Zimbabwe,1998,2006,50,50,6,6,6,0,0,1
AH Omarshah ,Zimbabwe,1983,1996,28,28,6,6,6,0,0,2
SD Outerbridge ,BER,2006,2009,23,23,6,6,6,0,0,1
LS Pascoe ,Australia,1977,1982,29,29,6,6,6,0,0,1
TRO Payne ,West Indies,1984,1987,7,7,6,6,4,2,0,2
VD Philander ,South Africa,2007,2015,30,28,6,6,6,0,0,2
AJ Pycroft ,Zimbabwe,1983,1992,20,20,6,6,6,0,0,2
CG Rackemann ,Australia,1983,1991,52,52,6,6,6,0,0,1
Rameez Shahzad ,United Arab Emirates,2016,2023,26,26,6,6,6,0,0,1
R Ravindra ,New Zealand,2023,2023,25,24,6,6,6,0,0,1
BA Reid ,Australia,1986,1992,61,61,6,6,6,0,0,2
AME Roberts ,West Indies,1975,1983,56,56,6,6,6,0,0,1
RT Robinson ,England,1984,1988,26,26,6,6,6,0,0,2
FA Rose ,West Indies,1997,2000,27,27,6,6,6,0,0,1
BM Scholtz ,Namibia,2019,2024,53,53,6,6,6,0,0,2
Shabir Noori ,Afghanistan,2010,2016,10,10,6,6,6,0,0,2
Sharafuddin Ashraf ,Afghanistan,2014,2024,20,20,6,6,6,0,0,3
Sharjeel Khan ,Pakistan,2013,2017,25,25,6,6,6,0,0,1
AK Sharma ,India,1988,1993,31,31,6,6,6,0,0,2
MM Sharma ,India,2013,2015,26,25,6,6,6,0,0,1
B Shikongo ,Namibia,2020,2024,20,20,6,6,6,0,0,1
RJ Sidebottom ,England,2001,2010,25,25,6,6,6,0,0,1
EO Simons ,South Africa,1994,1995,23,23,6,6,6,0,0,1
K Sinclair ,West Indies,2022,2023,7,7,6,6,6,0,0,2
TAM Siriwardana ,Sri Lanka,2015,2019,27,26,6,6,6,0,0,2
ZE Surkari ,Canada,2008,2011,23,22,6,6,6,0,0,1
Tanzid Hasan ,BAN,2023,2024,18,18,6,6,6,0,0,2
RML Taylor ,Scotland,2013,2016,15,15,6,6,6,0,0,2
Tushar Imran ,BAN,2001,2007,41,41,6,6,6,0,0,1
I Udana ,Sri Lanka,2012,2021,21,21,6,6,6,0,0,2
Umar Amin ,Pakistan,2010,2018,16,16,6,6,6,0,0,2
DL Underwood ,England,1973,1982,26,26,6,6,6,0,0,2
AV Vadher ,Kenya,1997,1999,18,18,6,6,6,0,0,2
PA van Meekeren ,NED,2013,2024,28,28,6,6,6,0,0,3
LP van Troost ,NED,2002,2007,23,23,6,6,6,0,0,1
Y Venugopal Rao ,India,2005,2006,16,16,6,6,6,0,0,2
R Vinay Kumar ,India,2010,2013,31,31,6,6,6,0,0,2
MHN Walker ,Australia,1974,1981,17,17,6,6,6,0,0,1
Washington Sundar ,India,2017,2024,22,21,6,6,6,0,0,1
AGD Wickremasinghe ,Sri Lanka,1992,1993,4,4,6,2,0,2,4,3
CG Williams ,Namibia,2019,2022,18,18,6,6,6,0,0,2
B Wood ,England,1972,1982,13,13,6,6,6,0,0,2
Yasir Shah ,Pakistan,2011,2019,25,25,6,6,6,0,0,2
Abdullah Shafique ,Pakistan,2022,2024,15,15,5,5,5,0,0,2
Abdul Shakoor ,United Arab Emirates,2015,2018,3,3,5,4,2,2,1,3
GI Allott ,New Zealand,1997,2000,31,31,5,5,5,0,0,1
Anshuman Rath ,Hong Kong,2014,2018,18,18,5,5,5,0,0,1
Arafat Sunny ,BAN,2014,2015,16,16,5,5,5,0,0,1
Arshad Ayub ,India,1987,1990,32,32,5,5,5,0,0,1
SJ Baard ,Namibia,2019,2022,19,19,5,5,5,0,0,1
JT Ball ,England,2016,2018,18,18,5,5,5,0,0,3
CA Best ,West Indies,1986,1992,24,23,5,5,5,0,0,2
U Bhatti ,Canada,2006,2010,36,35,5,5,5,0,0,1
SL Boock ,New Zealand,1978,1987,14,13,5,5,5,0,0,1
G Boycott ,England,1971,1981,36,35,5,5,5,0,0,3
DAJ Bracewell ,New Zealand,2011,2022,21,21,5,5,5,0,0,1
DH Brain ,Zimbabwe,1992,1995,23,23,5,5,5,0,0,2
RD Brown ,Zimbabwe,1983,1987,7,7,5,5,5,0,0,2
RJ Campbell ,Australia,2002,2002,2,2,5,4,0,4,1,3
KU Carty ,West Indies,2022,2024,28,28,5,5,5,0,0,1
MS Chapman (HKG/NZ),NA,2015,2024,26,25,5,5,5,0,0,1
IM Chappell ,Australia,1971,1980,16,16,5,5,5,0,0,2
PKD Chase ,Ireland,2015,2018,25,24,5,5,5,0,0,2
NG Cowans ,England,1983,1985,23,23,5,5,5,0,0,1
CE Cuffy ,West Indies,1994,2002,41,41,5,5,5,0,0,1
TK Curran ,England,2017,2021,28,28,5,5,5,0,0,1
WW Daniel ,West Indies,1978,1984,18,18,5,5,5,0,0,1
SP Davis ,Australia,1986,1988,39,39,5,5,5,0,0,1
MH Dekker ,Zimbabwe,1992,1996,23,23,5,5,5,0,0,1
JW Dernbach ,England,2011,2013,24,24,5,5,5,0,0,2
DS de Silva ,Sri Lanka,1975,1985,41,41,5,5,5,0,0,1
VC Drakes ,West Indies,1995,2004,34,34,5,5,5,0,0,1
GD Drummond ,Scotland,2007,2013,30,29,5,5,5,0,0,1
BM Duckett ,England,2016,2024,16,15,5,5,5,0,0,2
H Durham ,BER,2006,2006,9,9,5,5,5,0,0,2
GN Edwards ,New Zealand,1976,1981,6,6,5,5,3,2,0,2
RMS Eranga ,Sri Lanka,2011,2016,19,18,5,5,5,0,0,2
SM Ervine ,Zimbabwe,2001,2004,42,42,5,5,5,0,0,1
SE Findlay ,West Indies,2008,2009,9,9,5,5,5,0,0,2
ARC Fraser ,England,1989,1999,42,42,5,5,5,0,0,1
RS Gavaskar ,India,2004,2004,11,11,5,5,5,0,0,2
AFG Griffith ,West Indies,1996,2000,9,9,5,5,5,0,0,2
Hamid Hassan ,Afghanistan,2009,2019,38,37,5,5,5,0,0,1
Hamza Tahir ,Scotland,2019,2023,31,30,5,5,5,0,0,1
BR Hartland ,New Zealand,1992,1994,16,16,5,5,5,0,0,1
JW Hastings ,Australia,2010,2017,29,29,5,5,5,0,0,2
RC Haynes ,West Indies,1989,1991,8,8,5,5,5,0,0,2
EE Hemmings ,England,1982,1991,33,33,5,5,5,0,0,1
M Hendrick ,England,1973,1981,22,22,5,5,5,0,0,1
RS Higgins ,Zimbabwe,2006,2006,11,11,5,5,5,0,0,1
PJC Hoffmann ,Scotland,2006,2007,18,17,5,5,5,0,0,1
MJ Hoggard ,England,2001,2006,26,26,5,5,5,0,0,1
PJ Hughes ,Australia,2013,2014,25,25,5,5,3,2,0,2
RO Hurley ,West Indies,2003,2004,9,9,5,5,5,0,0,2
Imran Haider ,United Arab Emirates,2017,2019,20,20,5,5,5,0,0,1
WS Jayantha ,Sri Lanka,2004,2004,17,17,5,5,5,0,0,1
HAPW Jayawardene ,Sri Lanka,2003,2007,6,6,5,4,0,4,1,2
TE Jesty ,England,1983,1983,10,10,5,5,5,0,0,2
VB John ,Sri Lanka,1982,1987,45,45,5,5,5,0,0,1
MO Jones ,BER,2006,2007,12,12,5,5,5,0,0,3
Junaid Siddique ,United Arab Emirates,2019,2024,54,54,5,5,5,0,0,1
RJ Kirtley ,England,2001,2004,11,11,5,5,5,0,0,1
FJ Klaassen ,NED,2018,2023,19,19,5,5,5,0,0,2
Krishna Chandran ,United Arab Emirates,2014,2016,12,12,5,5,5,0,0,2
BP Kruger ,NED,2010,2011,5,5,5,5,5,0,0,3
BM Laird ,Australia,1979,1982,23,23,5,5,5,0,0,1
D Langford-Smith ,Ireland,2006,2008,22,21,5,5,5,0,0,2
JB Little ,Ireland,2019,2023,36,34,5,5,5,0,0,1
KS Lokuarachchi ,Sri Lanka,2003,2007,21,21,5,5,5,0,0,1
GI Maiden ,Scotland,2010,2011,7,7,5,5,0,5,0,3
GA Manou ,Australia,2009,2009,4,4,5,5,0,5,0,3
CM McBride ,Scotland,2022,2023,18,18,5,5,5,0,0,2
Milind Kumar ,United States of America,2024,2024,10,10,5,5,5,0,0,2
A Mishra ,India,2003,2016,36,35,5,5,5,0,0,1
Mohammad Asif (Asia/PAK),NA,2005,2010,38,36,5,5,5,0,0,2
Mohammad Hussain ,Pakistan,1997,1998,14,13,5,5,5,0,0,2
Mohammad Tauqir ,United Arab Emirates,2004,2015,11,11,5,5,5,0,0,2
KV Morea ,Papau New Guinea,2021,2023,17,17,5,5,5,0,0,2
MD Moxon ,England,1985,1988,8,8,5,5,5,0,0,2
Musa Ahmed ,NED,2021,2024,15,15,5,5,5,0,0,1
Pargat Singh ,Canada,2023,2024,18,18,5,5,5,0,0,1
AN Petersen ,South Africa,2006,2013,21,21,5,5,5,0,0,1
N Pothas ,South Africa,2000,2000,3,3,5,4,0,4,1,3
Qaiser Ali ,Canada,2006,2008,17,17,5,5,5,0,0,2
CAK Rajitha ,Sri Lanka,2018,2023,34,34,5,5,5,0,0,1
JF Reid ,New Zealand,1980,1986,25,23,5,5,5,0,0,1
DM Richards ,West Indies,2009,2010,8,8,5,5,5,0,0,2
JA Richardson ,Australia,2018,2022,15,15,5,5,5,0,0,1
Sadiq Mohammad ,Pakistan,1973,1980,19,19,5,5,5,0,0,2
MAR Samarasekera ,Sri Lanka,1983,1994,39,39,5,5,5,0,0,2
BS Sandhu ,India,1982,1984,22,21,5,5,5,0,0,1
Saud Shakeel ,Pakistan,2021,2023,15,15,5,5,5,0,0,1
Shahadat Hossain ,BAN,2006,2013,51,51,5,5,5,0,0,1
Shahriar Hossain ,BAN,1997,2004,20,20,5,5,5,0,0,1
Shapoor Zadran ,Afghanistan,2009,2019,44,44,5,5,5,0,0,1
R Shepherd ,West Indies,2019,2024,34,34,5,5,5,0,0,1
MW Short ,Australia,2023,2024,11,11,5,5,5,0,0,1
JN Snape ,England,2001,2002,10,10,5,5,5,0,0,2
S Snater ,NED,2018,2022,4,4,5,5,5,0,0,2
ELR Stewart ,South Africa,1993,2002,6,6,5,5,0,5,0,2
MR Swart ,NED,2011,2014,12,12,5,5,5,0,0,2
BM Tickner ,New Zealand,2022,2023,13,13,5,5,5,0,0,2
DT Tiripano ,Zimbabwe,2014,2022,38,37,5,5,5,0,0,1
JDF Vandersay ,Sri Lanka,2015,2024,28,28,5,5,5,0,0,1
Wajahatullah Wasti ,Pakistan,1999,2000,15,15,5,5,5,0,0,1
BGK Walker ,New Zealand,2000,2002,11,11,5,5,5,0,0,1
B Warnapura ,Sri Lanka,1975,1982,12,12,5,5,5,0,0,2
SR Waters ,Kenya,2008,2011,20,20,5,5,5,0,0,2
GH Worker ,New Zealand,2015,2018,10,10,5,5,5,0,0,3
GN Yallop ,Australia,1978,1984,30,27,5,5,5,0,0,2
Ziaur Rahman ,BAN,2013,2014,13,13,5,5,5,0,0,1
Adnan Mufti ,United Arab Emirates,2017,2018,18,18,4,4,4,0,0,1
Ahsan Malik ,NED,2011,2014,12,12,4,4,4,0,0,2
Amir Hayat ,United Arab Emirates,2018,2019,9,9,4,4,4,0,0,1
Anwar Ali ,Pakistan,2013,2016,22,22,4,4,4,0,0,2
J Arun Lal ,India,1982,1989,13,13,4,4,4,0,0,1
Atiq-uz-Zaman ,Pakistan,2000,2000,3,3,4,3,0,3,1,3
AM Bacher ,South Africa,1997,2005,13,13,4,4,4,0,0,2
SB Bangar ,India,2002,2004,15,15,4,4,4,0,0,2
GD Barlow ,England,1976,1977,6,6,4,4,4,0,0,2
GJ Batty ,England,2002,2009,10,10,4,4,4,0,0,2
AC Bedade ,India,1994,1994,13,12,4,4,4,0,0,1
BS Bedi ,India,1974,1979,10,10,4,4,4,0,0,3
KCG Benjamin ,West Indies,1992,1996,26,26,4,4,4,0,0,2
TL Best ,West Indies,2004,2014,26,26,4,4,4,0,0,1
Bilal Khan ,OMA,2019,2024,49,49,4,4,4,0,0,1
BR Blair ,New Zealand,1982,1986,14,13,4,4,4,0,0,2
CJ Bowes ,New Zealand,2023,2023,6,5,4,4,4,0,0,2
DR Brown (ENG/SCOT),NA,1997,2007,25,25,4,4,4,0,0,1
HR Bryan ,West Indies,1999,1999,15,15,4,4,4,0,0,1
IP Butchart ,Zimbabwe,1983,1995,20,20,4,4,4,0,0,1
GD Campbell ,Australia,1989,1990,12,12,4,4,4,0,0,1
KED Carroll ,Ireland,2007,2007,6,6,4,4,4,0,0,2
BB Chari ,Zimbabwe,2015,2020,14,13,4,3,2,1,1,2
R Chopra ,United Arab Emirates,2024,2024,11,11,4,4,4,0,0,2
DN Chudasama ,Kenya,1996,1999,20,20,4,4,4,0,0,1
ST Clarke ,West Indies,1978,1982,10,10,4,4,4,0,0,1
G Coetzee ,South Africa,2023,2023,14,14,4,4,4,0,0,2
GJ Cosier ,Australia,1975,1979,9,8,4,4,4,0,0,2
PC de Silva ,Sri Lanka,2014,2017,7,7,4,4,4,0,0,2
GR Dilley ,England,1979,1988,36,36,4,4,4,0,0,2
ST Doheny ,Ireland,2023,2024,11,11,4,3,3,0,1,2
MD du Preez ,Namibia,2021,2023,3,3,4,4,4,0,0,2
FH Edwards ,West Indies,2003,2009,50,49,4,4,4,0,0,1
D Elgar ,South Africa,2012,2018,8,8,4,4,4,0,0,2
FM Engineer ,India,1974,1975,5,5,4,3,0,3,1,1
KWR Fletcher ,England,1971,1982,24,23,4,4,4,0,0,1
DR Flynn ,New Zealand,2008,2012,20,20,4,4,4,0,0,1
PJ Forrest ,Australia,2012,2012,15,15,4,4,4,0,0,1
RC Fredericks ,West Indies,1973,1977,12,12,4,4,4,0,0,1
HJW Gardiner ,Scotland,2013,2015,11,11,4,4,4,0,0,2
HM Goonatilleke ,Sri Lanka,1982,1982,6,6,4,0,0,0,4,2
NA Greenwood ,JER,2023,2023,5,5,4,4,4,0,0,2
TR Gripper ,Zimbabwe,2001,2003,8,8,4,4,4,0,0,2
Hammad Azam ,Pakistan,2011,2015,11,11,4,4,4,0,0,2
AM Hardie ,Australia,2023,2024,11,11,4,4,4,0,0,2
Harmeet Singh ,United States of America,2024,2024,10,10,4,4,4,0,0,1
Haseeb Amjad ,Hong Kong,2014,2016,7,7,4,4,4,0,0,1
BF Hastings ,New Zealand,1973,1975,11,11,4,4,4,0,0,2
M Hayward ,South Africa,1998,2002,21,21,4,4,4,0,0,1
BE Hendricks ,South Africa,2019,2023,10,8,4,4,4,0,0,2
PA Hitchcock ,New Zealand,2002,2008,14,13,4,4,4,0,0,1
EH Hutchinson ,United States of America,2019,2021,11,11,4,4,4,0,0,2
Irfan Khan ,Pakistan,2024,2024,3,3,4,4,4,0,0,3
RD Jackman ,England,1974,1983,15,15,4,4,4,0,0,1
Jay Odedra ,OMA,2019,2024,16,16,4,4,4,0,0,1
MA Jones ,Scotland,2018,2024,16,16,4,4,4,0,0,1
SC Joseph ,West Indies,2000,2005,13,13,4,4,4,0,0,1
BD Julien ,West Indies,1973,1977,12,12,4,4,4,0,0,1
S Jyoti ,Canada,2006,2010,14,13,4,4,4,0,0,1
I Kaia ,Zimbabwe,2022,2023,19,17,4,4,4,0,0,1
RB Kanhai ,West Indies,1973,1975,7,7,4,4,4,0,0,1
MF Kent ,Australia,1981,1981,5,5,4,4,4,0,0,2
RD King ,West Indies,1998,2005,50,50,4,4,4,0,0,1
RK Kleinveldt ,South Africa,2013,2013,10,10,4,4,4,0,0,2
A Kuruvilla ,India,1997,1997,25,25,4,4,4,0,0,1
RP Lefebvre ,NED,1996,2003,11,11,4,4,4,0,0,1
RT Lyons ,Scotland,2006,2010,25,25,4,4,4,0,0,1
WK McCallan ,Ireland,2006,2009,39,37,4,4,4,0,0,1
MJ McClenaghan ,New Zealand,2013,2016,48,46,4,4,4,0,0,1
A McGrath ,England,2003,2004,14,13,4,4,4,0,0,2
MW Machan ,Scotland,2013,2016,23,22,4,4,4,0,0,1
AO Malhotra ,India,1982,1986,20,20,4,4,4,0,0,1
AA Mallett ,Australia,1971,1975,9,9,4,4,4,0,0,1
AD Mascarenhas ,England,2007,2009,20,20,4,4,4,0,0,2
MJ Mason ,New Zealand,2003,2010,26,25,4,4,4,0,0,1
MP Maynard ,England,1994,2000,14,13,4,4,4,0,0,1
PHKD Mendis ,Sri Lanka,2019,2024,14,14,4,4,4,0,0,2
G Miller ,England,1977,1984,25,25,4,4,4,0,0,2
Mohammad Naim ,BAN,2020,2023,8,8,4,4,4,0,0,2
Mohammad Saifuddin ,BAN,2017,2021,29,29,4,4,4,0,0,1
Mohammad Wasim (1) ,Pakistan,2022,2023,20,20,4,4,4,0,0,1
JN Mohammed ,West Indies,2011,2021,36,35,4,4,4,0,0,1
Mohsin Kamal ,Pakistan,1984,1989,19,19,4,4,4,0,0,1
Mominul Haque ,BAN,2012,2018,28,28,4,4,4,0,0,1
SJ Myburgh ,NED,2011,2022,22,22,4,4,4,0,0,1
Nasir Jamal ,Afghanistan,2014,2018,16,15,4,4,4,0,0,2
Naveen-ul-Haq ,Afghanistan,2016,2023,15,15,4,4,4,0,0,1
EO Odumbe ,Kenya,1996,1996,8,8,4,4,4,0,0,1
C Overton ,England,2018,2022,7,7,4,4,4,0,0,2
GAHM Parkar ,India,1982,1984,10,8,4,4,4,0,0,2
SS Pathirana ,Sri Lanka,2015,2017,18,18,4,4,4,0,0,2
ASA Perera ,Sri Lanka,1998,2001,20,20,4,4,4,0,0,2
NO Perry ,West Indies,1999,2000,21,21,4,4,4,0,0,3
MJ Petrie ,Scotland,2009,2009,4,4,4,3,0,3,1,2
AM Phangiso ,South Africa,2013,2016,21,21,4,4,4,0,0,1
IL Philip ,Scotland,1999,1999,3,3,4,4,4,0,0,3
Pramod Madushan ,Sri Lanka,2022,2024,9,9,4,4,4,0,0,2
Qasim Umar ,Pakistan,1983,1987,31,30,4,4,4,0,0,1
V Rathour ,India,1996,1997,7,7,4,4,4,0,0,2
Ravinderpal Singh ,Canada,2023,2024,6,6,4,4,4,0,0,2
PWE Rawson ,Zimbabwe,1983,1987,10,10,4,4,4,0,0,2
Raza-ur-Rehman ,Canada,2013,2014,6,6,4,4,4,0,0,4
V Razdan ,India,1989,1990,3,3,4,4,4,0,0,2
MJG Rippon ,NED,2013,2022,9,9,4,4,4,0,0,1
RD Robinson ,Australia,1977,1977,2,2,4,3,0,3,1,4
Saad Bin Zafar ,Canada,2023,2024,20,20,4,4,4,0,0,1
Saim Ayub ,Pakistan,2024,2024,3,3,4,4,4,0,0,2
RL Sanghvi ,India,1998,1998,10,10,4,4,4,0,0,2
Saqib Zulfiqar ,NED,2019,2023,15,15,4,4,4,0,0,2
P Sarraf ,NEP,2019,2024,12,12,4,4,4,0,0,1
AA Shafique ,OMA,2023,2023,2,2,4,2,0,2,2,3
Shahid Nazir ,Pakistan,1996,2000,17,17,4,4,4,0,0,1
A Shahzad ,England,2010,2011,11,11,4,4,4,0,0,2
SM Sharma ,United Arab Emirates,2023,2024,10,10,4,4,4,0,0,1
Shoriful Islam ,BAN,2021,2024,39,39,4,4,4,0,0,1
Sikander Bakht ,Pakistan,1977,1989,27,27,4,4,4,0,0,1
RB Simpson ,Australia,1978,1978,2,2,4,4,4,0,0,2
GM Strydom ,Zimbabwe,2006,2006,12,12,4,4,4,0,0,2
Tareq Aziz ,BAN,2002,2004,10,10,4,4,4,0,0,1
R Telemachus ,South Africa,1998,2006,37,37,4,4,4,0,0,1
S Thuraisingam ,Canada,2003,2008,10,10,4,4,4,0,0,2
T Thushara ,Sri Lanka,2008,2010,38,38,4,4,4,0,0,1
MK Tiwary ,India,2008,2015,12,11,4,4,4,0,0,3
CT Tremlett ,England,2005,2011,15,15,4,4,4,0,0,1
RJ Trott ,BER,2007,2009,11,11,4,4,4,0,0,1
PCR Tufnell ,England,1990,1997,20,20,4,4,4,0,0,2
AJ Turner ,Australia,2019,2021,9,9,4,4,4,0,0,1
Usman Limbada ,Canada,2010,2014,11,11,4,4,4,0,0,2
AC Valthapa ,United Arab Emirates,2023,2023,3,3,4,3,0,3,1,2
RH Vance ,New Zealand,1988,1989,8,8,4,4,4,0,0,2
M van Jaarsveld ,South Africa,2002,2004,11,11,4,4,4,0,0,1
SC van Schalkwyk ,United States of America,2024,2024,10,10,4,4,4,0,0,1
M van Schoor ,Namibia,2003,2003,5,5,4,4,0,4,0,2
JTC Vaughan ,New Zealand,1992,1996,18,18,4,4,4,0,0,1
S Venkataraghavan ,India,1974,1983,15,15,4,4,4,0,0,1
R Vijay Bharadwaj ,India,1999,2002,10,10,4,4,4,0,0,1
BV Vitori ,Zimbabwe,2011,2018,24,24,4,4,4,0,0,1
Waheed Ahmed ,United Arab Emirates,2019,2021,7,7,4,4,4,0,0,1
HR Walsh (USA/WI),NA,2019,2024,25,25,4,4,4,0,0,1
RM West ,Ireland,2008,2009,10,9,4,4,4,0,0,1
P Willey ,England,1977,1986,26,26,4,4,4,0,0,1
BA Williams ,Australia,2002,2004,25,24,4,4,4,0,0,2
JW Wilson ,New Zealand,1993,2005,6,6,4,4,4,0,0,2
Yamin Ahmadzai ,Afghanistan,2015,2022,9,9,4,4,4,0,0,1
Aamir Kaleem ,OMA,2019,2024,7,7,3,3,3,0,0,1
Abid Ali ,Pakistan,2019,2020,6,6,3,3,3,0,0,2
CJ Adams ,England,1998,2000,5,5,3,3,3,0,0,1
Adeel Raja ,NED,2002,2011,21,21,3,3,3,0,0,1
Adnan Akmal ,Pakistan,2011,2012,5,5,3,3,0,3,0,1
RG Aga ,Kenya,2004,2014,12,12,3,3,3,0,0,1
Aizaz Khan ,Hong Kong,2014,2018,19,19,3,3,3,0,0,1
MW Alleyne ,England,1999,2000,10,10,3,3,3,0,0,1
TR Ambrose ,England,2008,2008,5,5,3,3,0,3,0,1
J Anderson ,Ireland,2014,2016,8,8,3,3,3,0,0,2
KJ Arnott ,Zimbabwe,1987,1993,13,13,3,3,3,0,0,1
Avesh Khan ,India,2022,2023,8,8,3,3,3,0,0,3
Azeem Hafeez ,Pakistan,1983,1985,15,15,3,3,3,0,0,2
SV Bahutule ,India,1997,2003,8,8,3,3,3,0,0,2
WD Balaji Rao ,Canada,2008,2011,10,10,3,3,3,0,0,1
KNA Bandara ,Sri Lanka,2021,2023,6,6,3,3,3,0,0,2
ST Banerjee ,India,1991,1992,6,6,3,3,3,0,0,1
AB Barath ,West Indies,2010,2012,14,13,3,3,3,0,0,1
OO Bascome ,BER,2008,2008,6,6,3,3,3,0,0,1
JP Behrendorff ,Australia,2019,2022,12,12,3,3,3,0,0,1
DM Benkenstein ,South Africa,1998,2002,23,23,3,3,3,0,0,1
HK Bennett ,New Zealand,2010,2020,19,19,3,3,3,0,0,1
S Bhari ,NEP,2020,2022,11,11,3,3,3,0,0,2
STR Binny ,India,2014,2015,14,12,3,3,3,0,0,2
RJ Blakey ,England,1992,1993,3,3,3,2,0,2,1,2
SM Boland ,Australia,2016,2016,14,14,3,3,3,0,0,1
LE Bosman (Afr/SA),NA,2006,2010,14,14,3,3,3,0,0,2
KC Brathwaite ,West Indies,2016,2017,10,10,3,3,3,0,0,1
Y Cariah ,West Indies,2022,2023,14,14,3,3,3,0,0,2
CPS Chauhan ,India,1978,1981,7,7,3,3,3,0,0,1
NE Clarke ,NED,1996,1996,5,5,3,3,3,0,0,1
D Dasgupta ,India,2001,2001,5,5,3,2,0,2,1,1
AG Davies ,Scotland,1999,1999,5,5,3,2,0,2,1,2
AP Devcich ,New Zealand,2013,2016,12,12,3,3,3,0,0,1
N Dhamba ,OMA,2021,2022,10,10,3,3,3,0,0,2
LHD Dilhara ,Sri Lanka,2005,2013,9,9,3,3,3,0,0,1
DR Doshi ,India,1980,1982,15,15,3,3,3,0,0,1
Ehsan Khan ,Hong Kong,2016,2018,15,15,3,3,3,0,0,2
CE Eksteen ,South Africa,1991,1994,6,6,3,3,3,0,0,1
AM Ellis ,New Zealand,2012,2013,15,15,3,3,3,0,0,2
PA Emery ,Australia,1994,1994,1,1,3,3,0,3,0,3
JJ Esmeijer ,NED,2002,2003,6,6,3,3,3,0,0,2
GM Ewing ,Zimbabwe,2004,2005,7,7,3,3,3,0,0,2
Faisal Hossain ,BAN,2004,2010,6,6,3,3,3,0,0,1
Faisal Iqbal ,Pakistan,2000,2006,18,18,3,3,3,0,0,1
Fareed Ahmad ,Afghanistan,2014,2024,18,17,3,3,3,0,0,1
Fazalhaq Farooqi ,Afghanistan,2022,2024,37,37,3,3,3,0,0,1
TCB Fernando ,Sri Lanka,2001,2003,17,17,3,3,3,0,0,2
BT Foakes ,England,2019,2019,1,1,3,2,0,2,1,3
CR Foggo ,BER,2008,2008,4,4,3,3,3,0,0,2
MW Forde ,West Indies,2023,2024,8,8,3,3,3,0,0,2
S Fouche ,Namibia,2023,2024,9,9,3,3,3,0,0,1
OD Gibson ,West Indies,1995,1997,15,15,3,3,3,0,0,1
DR Gilbert ,Australia,1986,1986,14,14,3,3,3,0,0,1
BD Glover ,NED,2019,2023,9,9,3,3,3,0,0,1
AH Gray ,West Indies,1985,1991,25,25,3,3,3,0,0,1
EJ Gray ,New Zealand,1984,1988,10,10,3,3,3,0,0,2
PW Gunaratne ,Sri Lanka,2002,2003,23,23,3,3,3,0,0,1
Haroon Rasheed ,Pakistan,1977,1982,12,12,3,3,3,0,0,1
MJ Hay ,New Zealand,2024,2024,3,2,3,3,0,3,0,3
Hazratullah Zazai ,Afghanistan,2018,2019,16,15,3,3,3,0,0,1
DW Headley ,England,1996,1999,13,13,3,3,3,0,0,1
SP Heaney ,Canada,2006,2006,4,4,3,3,3,0,0,2
DJ Hooda ,India,2022,2022,10,9,3,3,3,0,0,1
HJ Howarth ,New Zealand,1973,1975,9,9,3,3,3,0,0,1
GI Hume ,Ireland,2022,2024,18,18,3,3,3,0,0,1
PJ Ingram ,New Zealand,2010,2010,8,8,3,3,3,0,0,1
Iqbal Qasim ,Pakistan,1977,1988,15,15,3,3,3,0,0,1
SD Jack ,South Africa,1994,1995,2,2,3,3,3,0,0,2
PA Jaques ,Australia,2006,2007,6,6,3,3,3,0,0,1
J Jarvis ,Scotland,2023,2024,9,9,3,3,3,0,0,1
Joginder Sharma ,India,2004,2007,4,4,3,3,3,0,0,1
Junaid Siddiqui ,Canada,2011,2024,11,11,3,3,3,0,0,1
Kaleem Sana ,Canada,2023,2024,16,16,3,3,3,0,0,1
Kashif Daud ,United Arab Emirates,2021,2022,19,19,3,3,3,0,0,1
SKW Kelly ,BER,2006,2009,10,10,3,3,3,0,0,1
D Keulder ,Namibia,2003,2003,6,6,3,3,3,0,0,2
AR Khurasiya ,India,1999,2001,12,12,3,3,3,0,0,1
Khurram Chohan ,Canada,2009,2014,25,24,3,3,3,0,0,1
Khurram Manzoor ,Pakistan,2008,2009,7,7,3,3,3,0,0,1
J Kila ,Papau New Guinea,2018,2022,13,13,3,3,3,0,0,1
R Klein ,NED,2022,2024,14,14,3,3,3,0,0,1
LJ Koen ,South Africa,1997,2000,5,5,3,3,3,0,0,2
DB Kotze ,Namibia,2003,2003,6,6,3,3,3,0,0,1
SP Krishnamurthi ,United States of America,2021,2024,6,6,3,3,3,0,0,2
AP Kuiper ,South Africa,1991,1996,25,25,3,3,3,0,0,1
T Kumaran ,India,1999,2000,8,8,3,3,3,0,0,1
JL Langer ,Australia,1994,1997,8,8,3,2,1,1,1,1
M Levitt ,NED,2024,2024,9,9,3,3,3,0,0,2
SH Lewis ,West Indies,2022,2022,1,1,3,3,3,0,0,3
GF Linde ,South Africa,2021,2021,2,2,3,3,3,0,0,2
D Lloyd ,England,1973,1980,8,8,3,3,3,0,0,1
BP Loots ,NED,2010,2011,7,7,3,3,3,0,0,2
CA Lynn ,Australia,2017,2018,4,4,3,3,3,0,0,2
RB McCosker ,Australia,1975,1982,14,14,3,3,3,0,0,1
AJ McKay ,New Zealand,2010,2012,19,19,3,3,3,0,0,1
N Madziva ,Zimbabwe,2014,2016,12,12,3,3,3,0,0,1
MAWR Madurasinghe ,Sri Lanka,1988,1992,12,12,3,3,3,0,0,1
Majid Khan ,Pakistan,1973,1982,23,23,3,3,3,0,0,1
A Martin ,West Indies,2011,2011,9,9,3,3,3,0,0,1
TBA May ,Australia,1987,1995,47,47,3,3,3,0,0,2
M Mbangwa ,Zimbabwe,1996,2002,29,29,3,3,3,0,0,1
CE McConchie ,New Zealand,2023,2023,6,5,3,3,3,0,0,1
SJ Modani ,United States of America,2021,2024,34,34,3,3,3,0,0,1
R Murray ,Zimbabwe,2018,2018,5,5,3,3,0,3,0,1
Mushtaq Mohammad ,Pakistan,1973,1978,10,10,3,3,3,0,0,1
D Myers ,Zimbabwe,2021,2022,5,5,3,3,3,0,0,1
Nasum Ahmed ,BAN,2022,2024,17,16,3,3,3,0,0,1
A Neill ,Scotland,2019,2023,9,9,3,3,3,0,0,1
JD Nel ,Scotland,2006,2010,19,19,3,3,3,0,0,1
RAP Nissanka ,Sri Lanka,2001,2003,23,23,3,3,3,0,0,1
A Nortje ,South Africa,2019,2023,22,21,3,3,3,0,0,2
LN Onyango ,Kenya,1996,2014,29,29,3,3,3,0,0,1
ARM Opatha ,Sri Lanka,1975,1979,5,5,3,3,3,0,0,2
MS Panesar ,England,2007,2007,26,26,3,3,3,0,0,1
MA Parker ,Scotland,2010,2010,10,10,3,3,3,0,0,1
JL Pattinson ,Australia,2011,2015,15,15,3,3,3,0,0,1
MJ Potts ,England,2022,2024,9,8,3,3,3,0,0,2
RR Powar ,India,2004,2007,31,30,3,3,3,0,0,1
M Prasidh Krishna ,India,2021,2023,17,17,3,3,3,0,0,1
MR Pydanna ,West Indies,1980,1983,3,3,3,2,0,2,1,1
S Ramesh ,India,1999,1999,24,23,3,3,3,0,0,1
SHA Rance ,New Zealand,2017,2017,2,2,3,3,3,0,0,3
Rashid Khan ,Pakistan,1980,1985,29,28,3,3,3,0,0,1
AJ Redmond ,New Zealand,2009,2010,6,6,3,3,3,0,0,1
RB Reid ,New Zealand,1988,1991,9,9,3,3,3,0,0,1
FL Reifer ,West Indies,1997,2009,8,8,3,3,3,0,0,1
Riaz Hassan ,Afghanistan,2022,2024,7,7,3,3,3,0,0,2
GR Robertson ,Australia,1994,1998,13,13,3,3,3,0,0,1
DB Rundle ,South Africa,1994,1994,2,2,3,3,3,0,0,2
NA Saini ,India,2019,2021,8,8,3,3,3,0,0,2
Saleem Jaffar ,Pakistan,1986,1990,39,39,3,3,3,0,0,1
DP Samaraweera ,Sri Lanka,1993,1994,5,5,3,3,3,0,0,2
MMC Schewe ,NED,1996,1996,5,5,3,2,0,2,1,3
E Schiferli ,NED,2002,2013,30,30,3,3,3,0,0,1
Shamsur Rahman ,BAN,2013,2014,10,10,3,3,3,0,0,2
KV Sharma ,India,2014,2014,2,2,3,3,3,0,0,2
M Shumba ,Zimbabwe,2021,2024,10,10,3,3,3,0,0,1
VRV Singh ,India,2006,2006,2,2,3,3,3,0,0,2
TT Smart ,Hong Kong,2004,2004,2,2,3,3,1,2,0,2
CJ Smith ,BER,2006,2007,12,12,3,3,3,0,0,2
JT Smuts ,South Africa,2020,2021,6,5,3,3,3,0,0,2
Sohail Khan ,Pakistan,2008,2016,13,13,3,3,3,0,0,1
MC Sorensen ,Ireland,2013,2016,13,12,3,3,3,0,0,1
CAH Stevenson ,United States of America,2019,2022,18,18,3,3,3,0,0,1
DA Stirling ,New Zealand,1984,1984,6,6,3,3,3,0,0,1
PC Strydom ,South Africa,2000,2000,10,10,3,3,3,0,0,2
R Strydom ,Ireland,2008,2008,9,8,3,3,3,0,0,1
Taijul Islam ,BAN,2014,2024,20,20,3,3,3,0,0,1
Tanveer Ahmed ,Hong Kong,2016,2018,6,6,3,3,3,0,0,2
Tanwir Afzal ,Hong Kong,2014,2018,20,20,3,3,3,0,0,1
APB Tennekoon ,Sri Lanka,1975,1979,4,4,3,3,3,0,0,1
AJ Traicos ,Zimbabwe,1983,1993,27,27,3,3,3,0,0,1
A Turner ,Australia,1975,1975,6,6,3,3,3,0,0,2
Usman Ghani ,Afghanistan,2014,2022,17,17,3,3,3,0,0,1
Usman Shinwari ,Pakistan,2017,2019,17,17,3,3,3,0,0,2
JJ van der Wath ,South Africa,2006,2007,10,10,3,3,3,0,0,1
GR Viswanath ,India,1974,1982,25,25,3,3,3,0,0,1
Waqas Barkat ,Hong Kong,2014,2018,10,10,3,3,3,0,0,1
B Ward ,JER,2023,2023,5,5,3,3,3,0,0,1
SM Warnapura ,Sri Lanka,2007,2008,3,3,3,3,3,0,0,2
Wasim Ali ,OMA,2022,2024,3,3,3,3,3,0,0,2
PN Webb ,New Zealand,1983,1984,5,5,3,3,0,3,0,1
K Weeraratne ,Sri Lanka,2000,2008,15,15,3,3,3,0,0,1
DS Wesonga ,Kenya,2010,2011,4,4,3,3,3,0,0,2
S Wettimuny ,Sri Lanka,1982,1987,35,35,3,3,3,0,0,1
BTJ Wheal ,Scotland,2016,2024,18,18,3,3,3,0,0,1
SG Whittingham ,Scotland,2017,2019,5,5,3,3,3,0,0,1
KIW Wijegunawardene ,Sri Lanka,1988,1992,26,26,3,3,3,0,0,1
RA Woolmer ,England,1972,1976,6,6,3,3,3,0,0,1
Jai P Yadav ,India,2002,2005,12,12,3,3,3,0,0,2
Yasir Ali ,BAN,2022,2023,9,8,3,3,3,0,0,1
M Zondeki (Afr/SA),NA,2002,2008,13,13,3,3,3,0,0,1
Aayan Afzal Khan ,United Arab Emirates,2022,2024,34,34,2,2,2,0,0,1
Abdur Rauf ,Pakistan,2008,2008,4,4,2,2,2,0,0,1
MA Agarwal ,India,2020,2020,5,5,2,2,2,0,0,1
Aizaz Cheema ,Pakistan,2011,2012,14,14,2,2,2,0,0,1
Akeem Jordan ,West Indies,2023,2023,2,2,2,2,2,0,0,2
Akif Raja ,United Arab Emirates,2022,2022,5,5,2,2,2,0,0,1
Ali Khan ,United States of America,2019,2023,15,15,2,2,2,0,0,1
Ali Naseer ,United Arab Emirates,2023,2024,17,17,2,2,2,0,0,1
PJW Allott ,England,1982,1985,13,13,2,2,2,0,0,1
SW Ambris ,West Indies,2017,2021,16,16,2,2,2,0,0,1
DL Amiss ,England,1972,1977,18,17,2,2,2,0,0,1
JO Angara ,Kenya,1997,2003,17,17,2,2,2,0,0,1
SA Ankola ,India,1989,1997,20,20,2,2,2,0,0,1
SSD Arachchige ,Sri Lanka,2023,2024,5,5,2,2,2,0,0,1
GG Arnold ,England,1972,1975,14,13,2,2,2,0,0,1
TD Astle ,New Zealand,2017,2019,9,9,2,2,2,0,0,1
Athar Ali Khan ,BAN,1988,1998,19,19,2,2,2,0,0,1
Azam Khan ,Pakistan,1996,1998,6,6,2,2,2,0,0,1
Azhar Hossain ,BAN,1988,1990,7,7,2,2,2,0,0,1
Azhar Saeed ,United Arab Emirates,1994,1996,7,7,2,2,2,0,0,1
OEG Baartman ,South Africa,2024,2024,3,3,2,2,2,0,0,2
Badal Singh ,OMA,2020,2020,2,2,2,2,2,0,0,2
S Badrinath ,India,2008,2011,7,7,2,2,2,0,0,2
T Banton ,England,2020,2020,6,6,2,2,2,0,0,1
IPP Batuwitarachchi ,United Arab Emirates,2008,2008,2,2,2,2,2,0,0,2
AR Berenger ,United Arab Emirates,2014,2015,10,10,2,2,2,0,0,1
JG Bethell ,England,2024,2024,8,8,2,2,2,0,0,1
RA Bhatti ,Canada,2011,2011,1,1,2,2,0,2,0,2
RL Bhudia ,Kenya,2008,2009,5,5,2,2,2,0,0,1
MP Bicknell ,England,1990,1991,7,7,2,2,2,0,0,1
Bilal Asif ,Pakistan,2015,2015,3,3,2,2,2,0,0,2
Bilawal Bhatti ,Pakistan,2013,2015,10,10,2,2,2,0,0,1
J Blackwood ,West Indies,2015,2022,3,3,2,2,2,0,0,1
PRP Boissevain ,NED,2021,2022,6,6,2,2,2,0,0,1
DCC Borden ,BER,2006,2008,12,12,2,2,2,0,0,1
GE Bradburn ,New Zealand,1990,2001,11,11,2,2,2,0,0,1
JT Brassell ,Namibia,2024,2024,7,7,2,2,2,0,0,1
RJ Bright ,Australia,1974,1986,11,11,2,2,2,0,0,1
HC Brook ,England,2023,2024,20,20,2,2,2,0,0,1
VR Brown ,New Zealand,1988,1988,3,3,2,2,2,0,0,1
PA Browne ,West Indies,2008,2008,5,5,2,2,0,2,0,1
MG Burmester ,Zimbabwe,1992,1995,8,8,2,2,2,0,0,1
JA Burns ,Australia,2015,2015,6,6,2,2,2,0,0,1
IW Callen ,Australia,1978,1982,5,5,2,2,2,0,0,1
J Cameron-Dow ,Ireland,2019,2019,4,4,2,2,2,0,0,1
MA Carberry ,England,2013,2014,6,5,2,2,2,0,0,1
JJ Celestine ,BER,2007,2008,8,8,2,2,2,0,0,1
DR Chumney ,Canada,2003,2007,21,21,2,2,2,0,0,1
D Cleaver ,New Zealand,2022,2022,1,1,2,2,0,2,0,2
PG Coman ,New Zealand,1973,1974,3,3,2,2,2,0,0,1
G Cook ,England,1981,1983,6,6,2,2,2,0,0,1
NGB Cook ,England,1984,1989,3,3,2,2,2,0,0,1
BN Cooper ,NED,2013,2021,13,13,2,2,2,0,0,1
JP Crawley ,England,1994,1999,13,13,2,1,1,0,1,1
DJ Cullen ,Australia,2006,2006,5,5,2,2,2,0,0,1
BJ Currie ,Scotland,2024,2024,9,9,2,2,2,0,0,1
EC D'Souza ,United Arab Emirates,2023,2023,3,3,2,2,2,0,0,2
D Daesrath ,Canada,2012,2013,4,4,2,2,2,0,0,2
Danish Kaneria ,Pakistan,2001,2007,18,18,2,2,2,0,0,1
HT Davis ,New Zealand,1994,1997,11,11,2,2,2,0,0,1
AC Dawson ,South Africa,1998,2004,19,19,2,2,2,0,0,1
LA Dawson ,England,2016,2022,6,5,2,2,2,0,0,1
J Da Silva ,West Indies,2021,2021,2,2,2,1,0,1,1,1
RP de Groen ,New Zealand,1993,1994,12,12,2,2,2,0,0,1
PA Desai ,Canada,2010,2014,13,13,2,2,2,0,0,1
GRA de Silva ,Sri Lanka,1975,1982,6,6,2,2,2,0,0,1
MW Douglas ,New Zealand,1994,1995,6,6,2,2,2,0,0,1
TM Dowlin ,West Indies,2009,2010,11,11,2,2,2,0,0,1
KG Duers ,Zimbabwe,1992,1992,6,6,2,2,2,0,0,1
SF Dukanwala ,United Arab Emirates,1996,1996,5,5,2,2,2,0,0,1
JSE Dunford ,JER,2023,2023,5,5,2,2,0,2,0,2
CI Dunusinghe ,Sri Lanka,1995,1995,1,1,2,1,0,1,1,2
NR Dyer ,Scotland,1999,1999,5,5,2,2,2,0,0,1
KA Edwards ,West Indies,2011,2014,16,16,2,2,2,0,0,1
Ehsan Nawaz ,Hong Kong,2014,2018,12,12,2,2,2,0,0,1
NT Ellis ,Australia,2022,2023,8,8,2,2,2,0,0,1
RM Ellison ,England,1984,1986,14,14,2,2,2,0,0,2
EA Essop-Adam ,Zimbabwe,1992,1992,1,1,2,2,2,0,0,2
Fahim Muntasir ,BAN,2001,2002,3,3,2,2,2,0,0,1
M Faraz Akram ,Zimbabwe,2024,2024,2,2,2,2,2,0,0,1
Faruk Ahmed ,BAN,1988,1999,7,7,2,2,2,0,0,1
AM Fernando ,Sri Lanka,2017,2024,15,14,2,2,2,0,0,1
KHRK Fernando ,Sri Lanka,2002,2006,7,7,2,2,2,0,0,1
C Floyd ,NED,2022,2024,10,10,2,2,2,0,0,2
AN French ,Hong Kong,2004,2004,2,2,2,2,2,0,0,1
D Gamage ,Sri Lanka,2003,2003,3,3,2,2,2,0,0,1
JC Gamage ,Sri Lanka,1995,1995,4,4,2,2,2,0,0,1
PLS Gamage ,Sri Lanka,2014,2017,9,9,2,2,2,0,0,1
KD Ghavri ,India,1975,1981,19,19,2,2,2,0,0,1
GJ Gilmour ,Australia,1974,1975,5,5,2,2,2,0,0,1
DM Gondaria ,Kenya,2013,2013,2,2,2,2,2,0,0,1
TG Gordon ,Canada,2011,2011,5,5,2,2,2,0,0,1
AGS Gous ,United States of America,2024,2024,5,5,2,2,2,0,0,2
JP Greaves ,West Indies,2022,2024,5,5,2,2,2,0,0,2
Z Groenewald ,Namibia,2019,2019,4,4,2,2,2,0,0,1
TGJ Gruijters ,NED,2010,2013,5,5,2,2,2,0,0,1
DR Hadlee ,New Zealand,1973,1976,11,11,2,2,2,0,0,1
Hafizur Rahman ,BAN,1986,1986,2,2,2,2,0,2,0,1
PL Harris ,South Africa,2008,2008,3,3,2,2,2,0,0,1
Hasan Mahmud ,BAN,2021,2023,22,21,2,2,2,0,0,1
C Hemraj ,West Indies,2018,2018,6,6,2,2,2,0,0,2
RO Hinds ,West Indies,2001,2004,14,14,2,2,2,0,0,1
H Hiri ,Papau New Guinea,2016,2023,34,34,2,2,2,0,0,1
ND Hirwani ,India,1988,1992,18,18,2,2,2,0,0,1
LG Howell ,New Zealand,1998,1998,12,12,2,2,2,0,0,1
GW Humpage ,England,1981,1981,3,3,2,2,0,2,0,1
N Ifill ,Canada,2003,2006,4,4,2,2,2,0,0,1
Ijaz Faqih ,Pakistan,1980,1988,27,27,2,2,2,0,0,1
IT Iqbal ,Kenya,1996,1996,3,3,2,2,0,2,0,2
AJ Ireland ,Zimbabwe,2005,2007,26,26,2,2,2,0,0,1
Irfan Ahmed ,Hong Kong,2008,2014,6,6,2,2,2,0,0,2
Jaker Ali ,BAN,2024,2024,2,2,2,1,0,1,1,1
KA Jamieson ,New Zealand,2020,2023,13,12,2,2,2,0,0,2
JNT Seales ,West Indies,2022,2024,15,15,2,2,2,0,0,1
JW Jenner ,JER,2023,2023,5,5,2,2,2,0,0,1
LR Johnson ,West Indies,2008,2015,6,6,2,2,2,0,0,1
T Kaitano ,Zimbabwe,2022,2024,11,11,2,2,2,0,0,1
SMS Kaluperuma ,Sri Lanka,1988,1988,2,2,2,2,2,0,0,1
SI Kamea ,Papau New Guinea,2022,2023,22,22,2,2,2,0,0,1
Khalid Kail ,OMA,2024,2024,5,5,2,2,2,0,0,1
JJ Krejza ,Australia,2011,2011,8,8,2,2,2,0,0,1
P Krishnamurthy ,India,1976,1976,1,1,2,1,0,1,1,2
N Kruger ,NED,2011,2011,2,2,2,2,2,0,0,2
MP Kuhnemann ,Australia,2022,2022,4,4,2,2,2,0,0,2
DS Kulkarni ,India,2014,2016,12,12,2,2,2,0,0,1
NM Kulkarni ,India,1997,1998,10,10,2,2,2,0,0,1
RR Kulkarni ,India,1983,1987,10,10,2,2,2,0,0,1
B Laughlin ,Australia,2009,2009,5,5,2,2,2,0,0,1
P Lever ,England,1971,1975,10,9,2,2,2,0,0,1
GD Lloyd ,England,1996,1998,6,6,2,2,2,0,0,1
Lovepreet Singh ,United Arab Emirates,2023,2023,2,2,2,2,2,0,0,1
SCG MacGill ,Australia,2000,2000,3,3,2,2,2,0,0,1
BJ McKechnie ,New Zealand,1975,1981,14,14,2,2,2,0,0,1
TSS Mackintosh ,Scotland,2023,2023,10,10,2,2,2,0,0,1
KH MacLeay ,Australia,1983,1987,16,16,2,2,2,0,0,1
TN Madondo ,Zimbabwe,1998,2001,13,13,2,2,2,0,0,1
SSB Magala ,South Africa,2021,2023,8,8,2,2,2,0,0,1
JN Maguire ,Australia,1983,1984,23,21,2,2,2,0,0,1
Mahedi Hasan ,BAN,2021,2023,11,11,2,2,2,0,0,1
I Maraj ,Canada,2003,2003,6,6,2,2,2,0,0,1
A Maregwede ,Zimbabwe,2003,2005,11,11,2,2,2,0,0,1
EH Mattis ,West Indies,1981,1981,2,2,2,2,2,0,0,1
B Mavuta ,Zimbabwe,2018,2023,12,10,2,2,2,0,0,1
TMK Mawoyo ,Zimbabwe,2006,2014,7,7,2,2,2,0,0,1
JA McCollum ,Ireland,2019,2021,10,10,2,2,2,0,0,1
MC Mendis ,Sri Lanka,1995,1995,1,1,2,2,2,0,0,2
Minhajul Abedin ,BAN,1986,1999,27,27,2,2,2,0,0,1
Mohammad Hasnain ,Pakistan,2019,2024,12,12,2,2,2,0,0,1
Mohammad Kashif ,NED,2006,2010,11,11,2,2,2,0,0,1
Mohammad Khalil ,Pakistan,2005,2005,3,3,2,2,2,0,0,1
Mohammad Shahzad ,United Arab Emirates,2014,2016,6,6,2,2,2,0,0,1
Mohammed Qasim ,United Arab Emirates,2017,2017,5,5,2,2,2,0,0,1
Mohibullah Oryakhel ,Afghanistan,2013,2013,2,2,2,2,2,0,0,1
GMC Mol ,NED,2007,2008,6,6,2,2,2,0,0,2
HJC Mol ,NED,2002,2008,11,11,2,2,2,0,0,1
PJK Mooney ,Ireland,2006,2007,4,4,2,2,2,0,0,2
JE Morris ,England,1990,1991,8,8,2,2,2,0,0,1
Morshed Ali Khan ,BAN,1998,1998,3,3,2,2,2,0,0,1
JK Moss ,Australia,1979,1979,1,1,2,2,2,0,0,2
Mrittunjoy Chowdhury ,BAN,2023,2023,1,1,2,2,2,0,0,2
EMDY Munaweera ,Sri Lanka,2017,2017,2,2,2,2,2,0,0,1
W Mwayenga ,Zimbabwe,2002,2004,3,3,2,2,2,0,0,1
Nafees Iqbal ,BAN,2003,2005,16,16,2,2,2,0,0,1
PG Nana ,East (and Central) Africa,1975,1975,3,3,2,2,2,0,0,1
Naseem Shah ,Pakistan,2022,2024,17,17,2,2,2,0,0,1
Nasir Ahmed ,BAN,1988,1990,7,7,2,1,0,1,1,1
Naved Latif ,Pakistan,2001,2003,11,11,2,2,2,0,0,1
Nazmul Islam ,BAN,2018,2018,5,5,2,2,2,0,0,1
TS Nethula ,New Zealand,2012,2012,5,5,2,2,2,0,0,1
VM Nyauchi ,Zimbabwe,2022,2023,10,10,2,2,2,0,0,1
FN Otieno ,Kenya,2010,2010,4,4,2,2,2,0,0,1
JV Paranjpe ,India,1998,1998,4,4,2,2,2,0,0,1
AP Patel ,Canada,2024,2024,2,2,2,2,2,0,0,1
TK Patel ,United States of America,2019,2020,7,7,2,2,2,0,0,1
D Paterson ,South Africa,2017,2019,4,4,2,2,2,0,0,2
GA Paterson ,Zimbabwe,1983,1987,10,10,2,2,2,0,0,1
M Pathirana ,Sri Lanka,2023,2023,12,12,2,2,2,0,0,1
MDK Perera ,Sri Lanka,2007,2018,13,12,2,2,2,0,0,1
PDRL Perera ,Sri Lanka,1999,2007,19,19,2,2,2,0,0,1
Pervez Mir ,Pakistan,1975,1977,3,3,2,2,2,0,0,1
RG Petrie ,New Zealand,1990,1991,12,12,2,2,2,0,0,1
A Phillip ,West Indies,2021,2022,5,5,2,2,2,0,0,1
OL Pitcher ,BER,2007,2007,5,5,2,2,2,0,0,1
MW Priest ,New Zealand,1990,1998,18,18,2,2,2,0,0,1
MW Pringle ,South Africa,1992,1994,17,17,2,2,2,0,0,1
PM Pushpakumara ,Sri Lanka,2017,2017,2,2,2,2,2,0,0,1
NV Radford ,England,1988,1988,6,6,2,2,2,0,0,2
Raees Ahmadzai ,Afghanistan,2009,2010,5,5,2,2,2,0,0,1
LS Rajput ,India,1985,1987,4,4,2,2,2,0,0,1
WV Raman ,India,1988,1996,27,27,2,2,2,0,0,1
S Ranatunga ,Sri Lanka,1994,1996,13,13,2,2,2,0,0,1
D Ravu ,Papau New Guinea,2017,2022,18,18,2,2,2,0,0,1
B Reddy ,India,1978,1981,3,3,2,2,0,2,0,1
IR Redpath ,Australia,1971,1975,5,5,2,2,2,0,0,1
Rishad Hossain ,BAN,2023,2024,4,4,2,2,2,0,0,2
Rizwan-uz-Zaman ,Pakistan,1981,1987,3,3,2,2,2,0,0,2
GK Robertson ,New Zealand,1981,1989,10,10,2,2,2,0,0,1
NA Rock ,Ireland,2022,2022,3,3,2,2,0,2,0,2
GA Rogers ,Scotland,2006,2008,13,12,2,2,2,0,0,1
GRJ Roope ,England,1973,1978,8,7,2,2,2,0,0,1
LG Rowe ,West Indies,1975,1980,11,11,2,2,2,0,0,1
Rumman Raees ,Pakistan,2017,2018,9,9,2,2,2,0,0,1
HD Rutherford ,New Zealand,2013,2013,4,4,2,2,2,0,0,1
Sabir Ali ,United Arab Emirates,2022,2023,4,4,2,2,2,0,0,1
Saeed Azad ,Pakistan,1995,1996,4,4,2,2,2,0,0,1
C Sakariya ,India,2021,2021,1,1,2,2,2,0,0,2
AM Salvi ,India,2003,2003,4,4,2,2,2,0,0,1
Sameer Zia ,United Arab Emirates,2004,2004,1,1,2,2,2,0,0,2
Saqib Ali ,United Arab Emirates,2008,2014,5,5,2,2,2,0,0,1
Saqlain Haider ,United Arab Emirates,2014,2016,5,5,2,1,0,1,1,1
Sarandeep Singh ,India,2002,2003,5,5,2,2,2,0,0,1
AF Sattaur ,Canada,2003,2003,3,3,2,2,2,0,0,2
S Seeraj ,Canada,2006,2006,1,1,2,2,0,2,0,2
KF Semple ,West Indies,1999,1999,7,7,2,2,2,0,0,1
CP Senanayake ,Sri Lanka,1990,1991,7,7,2,2,2,0,0,1
Shahidullah ,Afghanistan,2022,2023,3,3,2,2,2,0,0,1
Shahid Saeed ,Pakistan,1989,1993,10,10,2,2,2,0,0,1
Shahid Wasif ,Hong Kong,2016,2018,10,10,2,2,2,0,0,1
Shan Masood ,Pakistan,2019,2023,9,9,2,2,2,0,0,1
G Sharma ,India,1985,1987,11,11,2,2,2,0,0,1
PP Shaw ,India,2020,2021,6,6,2,2,2,0,0,1
TG Shaw ,South Africa,1991,1994,9,9,2,2,2,0,0,1
MQ Sheikh ,Scotland,2008,2010,7,7,2,2,2,0,0,1
IT Shillingford ,West Indies,1978,1978,2,2,2,2,2,0,0,1
HB Shipley ,New Zealand,2023,2023,8,8,2,2,2,0,0,1
DJM Short ,Australia,2018,2020,8,8,2,2,2,0,0,1
S Shrivastava ,OMA,2024,2024,4,4,2,2,2,0,0,1
ED Solkar ,India,1974,1976,7,7,2,2,2,0,0,1
IM Stanger ,Scotland,1999,2006,5,5,2,2,2,0,0,1
GB Stevenson ,England,1980,1981,4,4,2,2,2,0,0,1
OP Stone ,England,2018,2024,10,9,2,2,2,0,0,2
AM Stuart ,Australia,1997,1997,3,3,2,2,2,0,0,2
T Stubbs ,South Africa,2023,2024,7,7,2,2,2,0,0,1
V Sukumaran ,United Arab Emirates,2022,2024,10,10,2,2,2,0,0,1
T Suri ,United Arab Emirates,2024,2024,4,4,2,2,1,1,0,1
Taslim Arif ,Pakistan,1980,1980,2,2,2,1,1,0,1,1
C Tear ,Scotland,2024,2024,10,10,2,2,2,0,0,1
SP Terry ,Ireland,2016,2016,5,5,2,2,2,0,0,2
LO Tikolo ,Kenya,1996,1996,3,3,2,2,2,0,0,1
SS Tiwary ,India,2010,2010,3,3,2,2,2,0,0,1
AM Tribe ,JER,2023,2023,5,5,2,2,2,0,0,1
GB Troup ,New Zealand,1976,1985,22,22,2,2,2,0,0,1
TE Tucker ,BER,2008,2009,5,5,2,2,2,0,0,1
Umran Malik ,India,2022,2023,10,9,2,2,2,0,0,1
KEA Upashantha ,Sri Lanka,1995,2001,12,12,2,2,2,0,0,1
PS Vaidya ,India,1995,1996,4,4,2,2,2,0,0,1
RF van Oosterom ,NED,1996,2002,3,3,2,2,2,0,0,1
C Viljoen ,Namibia,2019,2019,2,2,2,2,2,0,0,2
TP Visee ,NED,2019,2021,3,3,2,2,2,0,0,1
KDK Vithanage ,Sri Lanka,2013,2014,6,6,2,2,2,0,0,1
MDJ Walker ,New Zealand,2003,2003,3,3,2,2,2,0,0,1
KPJ Warnaweera ,Sri Lanka,1990,1993,6,6,2,2,2,0,0,1
AS Wassan ,India,1990,1991,9,9,2,2,2,0,0,1
DS Weerakkody ,Sri Lanka,2017,2017,3,3,2,2,2,0,0,1
UWMBCA Welegedara ,Sri Lanka,2009,2010,10,9,2,2,2,0,0,1
JM Wiener ,Australia,1979,1980,7,7,2,2,2,0,0,1
D Wiese (NAM/SA),NA,2015,2022,15,15,2,2,2,0,0,1
RGCE Wijesuriya ,Sri Lanka,1982,1985,8,8,2,2,2,0,0,1
HS Williams ,South Africa,1999,2000,7,7,2,2,2,0,0,2
PJ Wiseman ,New Zealand,1998,2003,15,14,2,2,2,0,0,1
RD Woolley ,Australia,1983,1983,4,2,2,1,0,1,1,2
Yasir Arafat ,Pakistan,2000,2009,11,11,2,2,2,0,0,1
B Yograj Singh ,India,1980,1981,6,6,2,2,2,0,0,1
BE Young ,Australia,1998,1999,6,6,2,2,2,0,0,1
Zahid Fazal ,Pakistan,1990,1994,19,19,2,2,2,0,0,1
Zahoor Elahi ,Pakistan,1996,1997,14,14,2,2,2,0,0,1
Zulqarnain Haider ,Pakistan,2010,2010,4,4,2,1,0,1,1,2
Mohammad Aadil Alam ,NEP,2022,2022,6,6,1,1,1,0,0,1
Aaditya Varadarajan ,Canada,2024,2024,3,3,1,1,1,0,0,1
Aakash Chand ,NEP,2024,2024,2,2,1,1,1,0,0,1
Aamer Hameed ,Pakistan,1977,1978,2,2,1,1,1,0,0,1
VR Aaron ,India,2011,2014,9,9,1,1,1,0,0,1
JS Ababu ,Kenya,1999,2006,9,9,1,1,1,0,0,1
Abdullah Mazari ,Afghanistan,2010,2010,2,2,1,1,1,0,0,1
Abdul Jabbar ,Canada,2007,2007,2,2,1,1,1,0,0,1
S Abrahams ,South Africa,2000,2000,1,1,1,1,1,0,0,1
Abul Hasan ,BAN,2012,2018,7,7,1,1,1,0,0,1
Abu Hider ,BAN,2018,2018,2,2,1,1,1,0,0,1
Adhitya Shetty ,United Arab Emirates,2023,2023,1,1,1,1,1,0,0,1
Afzaal Haider ,Hong Kong,2004,2008,4,4,1,1,1,0,0,1
JP Agnew ,England,1985,1985,3,3,1,1,1,0,0,1
KK Ahmed ,India,2018,2019,11,11,1,1,1,0,0,1
Rehan Ahmed ,England,2023,2023,6,5,1,1,1,0,0,1
Aijaz Ali ,United States of America,2004,2004,2,2,1,1,1,0,0,1
Kabir Ali ,England,2003,2006,14,13,1,1,1,0,0,1
RW Ali ,Kenya,1996,1997,9,9,1,1,1,0,0,1
DI Allan ,Kenya,2011,2013,5,5,1,1,1,0,0,1
MJD Allingham ,Scotland,1999,1999,3,3,1,1,1,0,0,1
Al-Amin Hossain ,BAN,2014,2020,15,15,1,1,1,0,0,1
S Amarnath ,India,1978,1978,3,3,1,1,1,0,0,1
MKDI Amerasinghe ,Sri Lanka,2007,2008,8,8,1,1,1,0,0,1
CR Amini ,Papau New Guinea,2014,2014,2,2,1,1,1,0,0,1
RW Anderson ,New Zealand,1976,1978,2,2,1,1,1,0,0,1
Ankur Vasishta ,Hong Kong,2014,2014,4,4,1,1,1,0,0,1
Arshad Ali ,United Arab Emirates,2004,2008,4,4,1,1,1,0,0,1
Arshad Laeeq ,United Arab Emirates,1994,1996,6,6,1,1,1,0,0,1
Arshdeep Singh ,India,2022,2024,8,7,1,1,1,0,0,1
A Ashok ,New Zealand,2023,2023,2,2,1,1,1,0,0,1
Asif Masood ,Pakistan,1973,1976,7,7,1,1,1,0,0,1
AAP Atkinson ,England,2023,2023,9,9,1,1,1,0,0,1
RJ Bailey ,England,1985,1990,4,4,1,1,1,0,0,1
LS Baker ,West Indies,2008,2009,10,9,1,1,1,0,0,1
TC Bastiampillai ,Canada,2007,2014,13,13,1,1,1,0,0,1
MD Bates ,New Zealand,2012,2012,2,2,1,1,1,0,0,1
Bazid Khan ,Pakistan,2004,2008,5,5,1,1,1,0,0,1
MD Bell ,New Zealand,1998,2001,7,7,1,1,1,0,0,1
MJ Bennett ,Australia,1984,1985,8,8,1,1,1,0,0,1
U Bhagwan ,Canada,2024,2024,4,4,1,1,1,0,0,1
Bikram Sob ,NEP,2021,2022,5,5,1,1,1,0,0,1
GA Bishop ,Australia,1987,1987,2,2,1,1,1,0,0,1
GH Bodi ,South Africa,2007,2007,2,2,1,1,1,0,0,1
NE Bonner ,West Indies,2021,2022,6,6,1,1,1,0,0,1
JWHD Boteju ,Sri Lanka,1999,1999,2,2,1,1,1,0,0,1
JE Brinkley ,Scotland,1999,1999,5,5,1,1,1,0,0,1
RE Bryson ,South Africa,1997,1997,7,7,1,1,1,0,0,1
CE Bulfin ,New Zealand,1999,1999,4,4,1,1,1,0,0,1
SF Burger ,Namibia,2003,2003,2,2,1,1,1,0,0,1
SJ Cameron ,Scotland,2018,2018,2,2,1,1,1,0,0,1
TK Canning ,New Zealand,2003,2005,4,4,1,1,1,0,0,1
HWR Cartwright ,Australia,2017,2017,2,2,1,1,1,0,0,1
DL Chahar ,India,2018,2022,13,12,1,1,1,0,0,1
U Chatterjee ,India,1995,1995,3,3,1,1,1,0,0,1
TL Chivanga ,Zimbabwe,2022,2023,8,7,1,1,1,0,0,1
JA Clarkson ,New Zealand,2023,2023,3,3,1,1,1,0,0,1
DB Close ,England,1972,1972,3,3,1,1,1,0,0,1
RO Collinge ,New Zealand,1973,1978,15,15,1,1,1,0,0,1
M Commins ,Ireland,2023,2023,2,2,1,1,1,0,0,1
PC Connell ,Ireland,2008,2010,13,12,1,1,1,0,0,1
SJ Cook ,South Africa,1991,1993,4,4,1,1,1,0,0,1
JM Cox ,England,2024,2024,3,3,1,1,1,0,0,1
GJ Crocker ,Zimbabwe,1992,1993,6,6,1,1,1,0,0,1
CEH Croft ,West Indies,1977,1981,19,19,1,1,1,0,0,1
ML Cummins ,West Indies,2014,2017,11,10,1,1,1,0,0,1
KM Curran ,Zimbabwe,1983,1987,11,11,1,1,1,0,0,1
BCJ Cutting ,Australia,2013,2014,4,4,1,1,1,0,0,1
DDP D'Silva ,United Arab Emirates,2019,2020,6,6,1,1,1,0,0,1
CJ Dala ,South Africa,2018,2018,2,2,1,1,1,0,0,1
WW Davis ,West Indies,1983,1988,35,35,1,1,1,0,0,1
MH Denness ,England,1973,1975,12,12,1,1,1,0,0,1
JH Desai ,United States of America,2004,2004,1,1,1,1,1,0,0,1
DLS de Silva ,Sri Lanka,1979,1979,2,2,1,1,1,0,0,1
S Dhakal ,NEP,2022,2022,8,8,1,1,1,0,0,1
R Dhanraj ,West Indies,1994,1995,6,6,1,1,1,0,0,1
BJ Diamanti ,New Zealand,2009,2009,1,1,1,1,1,0,0,1
AB Dinda ,India,2010,2013,13,13,1,1,1,0,0,1
MJ Di Venuto ,Australia,1997,1997,9,9,1,1,1,0,0,1
BL D'Oliveira ,England,1971,1972,4,4,1,1,1,0,0,1
DC Drakes ,West Indies,2023,2023,3,3,1,1,1,0,0,1
CJ Drum ,New Zealand,1999,1999,5,5,1,1,1,0,0,1
S Dube ,India,2019,2024,4,4,1,1,1,0,0,1
N Dutta ,Canada,2013,2024,7,7,1,1,1,0,0,1
G Dymock ,Australia,1974,1980,15,14,1,1,1,0,0,1
Ebadot Hossain ,BAN,2022,2023,12,11,1,1,1,0,0,1
RR Emrit ,West Indies,2007,2007,2,2,1,1,1,0,0,1
MM English ,Scotland,2024,2024,1,1,1,1,1,0,0,1
Fahad Usman ,United Arab Emirates,2004,2004,2,2,1,1,1,0,0,1
Fazle Mahmud ,BAN,2018,2018,2,2,1,1,1,0,0,1
B Fernando ,Sri Lanka,2021,2021,4,3,1,1,1,0,0,1
BOP Fernando ,Sri Lanka,2019,2021,8,7,1,1,1,0,0,1
KADM Fernando ,Sri Lanka,2003,2003,1,1,1,1,1,0,0,1
J Figy ,United Arab Emirates,2019,2020,2,2,1,1,1,0,0,1
MV Fleming ,England,1997,1998,11,11,1,1,1,0,0,1
MJ Fourie ,Ireland,2007,2008,7,6,1,1,1,0,0,1
PJ Franks ,England,2000,2000,1,1,1,1,1,0,0,1
J Fraser-McGurk ,Australia,2024,2024,5,5,1,1,1,0,0,1
RS Gabriel ,West Indies,1984,1984,11,11,1,1,1,0,0,1
ST Gabriel ,West Indies,2016,2019,25,25,1,1,1,0,0,1
RD Gaikwad ,India,2022,2023,6,6,1,1,1,0,0,1
WCA Ganegama ,Sri Lanka,2001,2006,4,4,1,1,1,0,0,1
TN Garwe ,Zimbabwe,2009,2009,1,1,1,1,1,0,0,1
SP Gauchan ,NEP,2018,2018,1,1,1,1,1,0,0,1
Gazi Ashraf ,BAN,1986,1990,7,7,1,1,1,0,0,1
B Geeves ,Australia,2008,2009,2,2,1,1,1,0,0,1
SC Getkate ,Ireland,2019,2021,4,4,1,1,1,0,0,1
AM Ghazanfar ,Afghanistan,2024,2024,8,8,1,1,1,0,0,1
N Gifford ,England,1985,1985,2,2,1,1,1,0,0,1
JOA Gordon ,Canada,2012,2024,12,12,1,1,1,0,0,1
K Gowtham ,India,2021,2021,1,1,1,1,1,0,0,1
SF Graf ,Australia,1980,1981,11,11,1,1,1,0,0,1
AP Grayson ,England,2000,2001,2,2,1,1,1,0,0,1
Gurkeerat Singh ,India,2016,2016,3,3,1,1,1,0,0,1
HF Gurney ,England,2014,2014,10,10,1,1,1,0,0,1
Gursharan Singh ,India,1990,1990,1,1,1,1,1,0,0,1
AM Guruge ,United Arab Emirates,2014,2015,7,7,1,1,1,0,0,1
Haider Ali ,Pakistan,2020,2020,2,2,1,1,1,0,0,1
RS Haire ,Ireland,2008,2008,2,2,1,1,1,0,0,1
JV Harris ,Canada,2003,2003,6,6,1,1,1,0,0,1
RG Hart ,New Zealand,2002,2002,2,2,1,1,0,1,0,1
Hasan Jamil ,Pakistan,1977,1978,6,6,1,1,1,0,0,1
Hasan Raza ,Pakistan,1996,1999,16,15,1,1,1,0,0,1
TJ Heggelman ,NED,2010,2011,5,5,1,1,1,0,0,1
MADI Hemantha ,Sri Lanka,2023,2023,5,5,1,1,1,0,0,1
O Henry ,South Africa,1992,1992,3,3,1,1,1,0,0,1
JG Heron ,Zimbabwe,1983,1983,6,6,1,1,1,0,0,1
D Heyliger ,Canada,2023,2024,16,16,1,1,1,0,0,1
PD Heyn ,Sri Lanka,1975,1975,2,2,1,1,1,0,0,1
AMJ Hilditch ,Australia,1979,1985,8,8,1,1,1,0,0,1
KC Hodsoll ,BER,2007,2008,3,3,1,1,1,0,0,1
G Hoey ,Ireland,2024,2024,2,2,1,1,1,0,0,1
CK Hooper ,Canada,2007,2010,5,5,1,1,1,0,0,1
KA Hope ,West Indies,2017,2017,7,7,1,1,1,0,0,1
AG Hurst ,Australia,1975,1979,8,7,1,1,1,0,0,1
RO Hussain ,Scotland,2006,2010,8,7,1,1,1,0,0,1
KH Butt ,Hong Kong,2008,2008,2,2,1,1,1,0,0,1
DP Hyatt ,West Indies,2011,2011,9,9,1,1,1,0,0,1
AP Igglesden ,England,1994,1994,4,4,1,1,1,0,0,1
Ijaz Ahmed jnr ,Pakistan,1997,1997,2,2,1,1,1,0,0,1
R Illingworth ,England,1971,1973,3,2,1,1,1,0,0,1
Imran Abbas ,Pakistan,2000,2000,2,2,1,1,1,0,0,1
MM Iqbal ,Scotland,2009,2014,13,13,1,1,1,0,0,1
Irfan Bhatti ,Pakistan,1993,1993,1,1,1,1,1,0,0,1
Izatullah Dawlatzai ,Afghanistan,2010,2015,5,5,1,1,1,0,0,1
Jahangir Alam ,BAN,1997,1999,3,3,1,0,0,0,1,1
Jahangir Shah ,BAN,1986,1990,5,5,1,1,1,0,0,1
Jalal-ud-Din ,Pakistan,1982,1983,8,7,1,1,1,0,0,1
Jamaluddin Ahmed ,BAN,2003,2003,1,1,1,1,1,0,0,1
F Jansen ,NED,1996,1996,2,2,1,1,1,0,0,1
MP Jarvis ,Zimbabwe,1987,1995,12,12,1,1,1,0,0,1
PW Jarvis ,England,1988,1993,16,16,1,1,1,0,0,1
Javed Qadeer ,Pakistan,1995,1995,1,1,1,1,0,1,0,1
SA Jayasinghe ,Sri Lanka,1979,1979,2,2,1,1,0,1,0,1
GSNFG Jayasuriya ,Sri Lanka,2015,2019,12,12,1,1,1,0,0,1
S Jeganathan ,Sri Lanka,1983,1988,5,5,1,1,1,0,0,1
MR Johnson ,United States of America,2004,2004,2,2,1,1,0,1,0,1
MBS Jonkman ,NED,2006,2010,16,16,1,1,1,0,0,1
MMA Jonkman ,NED,2007,2010,4,4,1,1,1,0,0,1
S Jora ,NEP,2019,2023,5,5,1,1,1,0,0,1
DI Joyce ,Ireland,2006,2007,3,3,1,1,1,0,0,1
Jubair Hossain ,BAN,2014,2015,3,3,1,1,1,0,0,1
Kabir Khan ,Pakistan,1994,2000,10,9,1,1,1,0,0,1
Kamran Shazad ,United Arab Emirates,2014,2015,4,4,1,1,1,0,0,1
TS Kamunhukamwe ,Zimbabwe,2018,2024,12,11,1,1,1,0,0,1
AR Kapoor ,India,1995,2000,17,17,1,1,1,0,0,1
M Karg ,Namibia,2003,2003,3,3,1,1,0,1,0,1
SHU Karnain ,Sri Lanka,1984,1990,19,19,1,1,1,0,0,1
S Kaul ,India,2018,2018,3,3,1,1,1,0,0,1
RJ Kennedy ,New Zealand,1996,1996,7,7,1,1,1,0,0,1
JC Kent ,South Africa,2002,2002,2,2,1,1,1,0,0,1
RB Kerr ,Australia,1985,1985,4,4,1,1,1,0,0,1
S Keshvani ,Canada,2009,2009,5,4,1,1,1,0,0,1
SP Khakurel ,NEP,2018,2022,6,6,1,0,0,0,1,1
Khalid Latif ,Pakistan,2008,2010,5,5,1,1,1,0,0,1
Khurram Nawaz ,OMA,2019,2019,3,3,1,1,1,0,0,1
GE Kidd ,Ireland,2007,2008,6,5,1,1,1,0,0,1
K Klein ,NED,2024,2024,8,8,1,1,1,0,0,1
JF Kloppenburg ,NED,2002,2003,6,6,1,1,1,0,0,1
BL Kotze ,Namibia,2003,2003,5,5,1,1,1,0,0,1
JP Kotze ,Namibia,2019,2024,18,18,1,1,0,1,0,1
GJP Kruger ,South Africa,2006,2006,3,3,1,1,1,0,0,1
CKB Kulasekara ,Sri Lanka,2011,2012,4,4,1,1,1,0,0,1
D Lakshan ,Sri Lanka,2021,2022,3,3,1,1,1,0,0,1
JPR Lamsam ,Hong Kong,2004,2008,2,2,1,1,1,0,0,1
JAD Lawrenson ,JER,2023,2023,5,5,1,1,1,0,0,1
WM Lawry ,Australia,1971,1971,1,1,1,1,1,0,0,1
DO Leicher ,Namibia,2024,2024,2,2,1,1,1,0,0,1
ML Lewis ,Australia,2005,2006,7,7,1,1,1,0,0,1
J Liyanage ,Sri Lanka,2024,2024,18,18,1,1,1,0,0,1
ACI Lock ,Zimbabwe,1996,1996,8,7,1,1,1,0,0,1
JL Louw ,Namibia,2003,2003,1,1,1,1,1,0,0,1
JD Love ,England,1981,1981,3,3,1,1,1,0,0,1
SW Lubbers ,NED,1996,1996,4,4,1,1,1,0,0,1
MJ Lumb ,England,2014,2014,3,3,1,1,1,0,0,1
AS Luseno ,Kenya,2003,2010,10,10,1,1,1,0,0,1
MA Lynch ,England,1988,1988,3,3,1,1,1,0,0,1
RJ McCurdy ,Australia,1985,1985,11,11,1,1,1,0,0,1
PE McEwan ,New Zealand,1980,1985,17,17,1,1,1,0,0,1
AJ Mackay ,Zimbabwe,2001,2001,3,3,1,1,1,0,0,1
GD McKenzie ,Australia,1971,1971,1,1,1,1,1,0,0,1
DL Maddy ,England,1998,2000,8,8,1,1,1,0,0,1
Mafizur Rahman ,BAN,1997,1997,4,4,1,1,1,0,0,1
Mahbubul Alam ,BAN,2009,2009,5,5,1,1,1,0,0,1
S Mahmood ,England,2020,2024,9,9,1,1,1,0,0,1
SI Mahmood ,England,2004,2009,26,26,1,1,1,0,0,1
DE Malcolm ,England,1990,1994,10,10,1,1,1,0,0,1
MF Malone ,Australia,1977,1982,10,10,1,1,1,0,0,1
Manzoor Akhtar ,Pakistan,1997,1998,7,7,1,1,1,0,0,1
PJ Martin ,England,1995,1998,20,20,1,1,1,0,0,1
T Marumani ,Zimbabwe,2021,2023,12,11,1,1,1,0,0,1
RAL Massie ,Australia,1972,1972,3,3,1,1,1,0,0,1
EZ Matambanadzo ,Zimbabwe,1996,1997,7,7,1,1,1,0,0,1
Mazhar Hussain ,United Arab Emirates,1994,1996,7,7,1,1,1,0,0,1
V Mehra ,United Arab Emirates,1994,1996,6,6,1,1,1,0,0,1
RTM Mendis ,Sri Lanka,2021,2022,4,4,1,1,1,0,0,1
KO Meth ,Zimbabwe,2006,2012,11,11,1,1,1,0,0,1
JP Millmow ,New Zealand,1990,1990,5,5,1,1,1,0,0,1
A Mithun ,India,2010,2011,5,5,1,1,1,0,0,1
Mohammad Boota ,United Arab Emirates,2018,2019,9,9,1,0,0,0,1,1
Mohammad Ishaq ,United Arab Emirates,1994,1996,5,5,1,1,1,0,0,1
Mohammad Saleem ,Afghanistan,2023,2023,2,2,1,1,1,0,0,1
Mohammad Salim ,BAN,2003,2003,1,1,1,1,0,1,0,1
Mohammad Sharif ,BAN,2001,2007,9,9,1,1,1,0,0,1
Mohammad Zahid ,Pakistan,1996,2002,11,11,1,1,1,0,0,1
D Mohammed ,West Indies,2006,2008,7,7,1,1,1,0,0,1
LR Morris ,Australia,2024,2024,3,3,1,1,1,0,0,1
Mosharraf Hossain ,BAN,2008,2016,5,5,1,1,1,0,0,1
DR Mousley ,England,2024,2024,3,3,1,1,1,0,0,1
TV Mufambisi ,Zimbabwe,2006,2007,6,6,1,1,0,1,0,1
Muzahir Raza ,OMA,2024,2024,4,4,1,1,1,0,0,1
Muhammad Farooq ,United Arab Emirates,2024,2024,2,2,1,1,1,0,0,1
Muhammad Jawadullah ,United Arab Emirates,2023,2024,7,7,1,1,1,0,0,1
Mukesh Kumar ,India,2023,2023,6,6,1,1,1,0,0,1
SP Mukherjee ,India,1990,1991,3,3,1,1,1,0,0,1
J Mulder ,Ireland,2017,2017,4,4,1,1,1,0,0,1
CT Mumba ,Zimbabwe,2016,2020,7,7,1,1,1,0,0,1
T Munyonga ,Zimbabwe,2022,2023,7,7,1,1,1,0,0,1
N M'shangwe ,Zimbabwe,2011,2014,6,6,1,1,1,0,0,1
DT Mutendera ,Zimbabwe,1999,2001,9,9,1,1,1,0,0,1
G Mylvaganam ,United Arab Emirates,1996,1996,3,3,1,1,1,0,0,1
Naeemuddin Aslam ,United Arab Emirates,2004,2004,2,2,1,1,1,0,0,1
Naeem Ahmed ,Pakistan,1978,1978,1,1,1,1,1,0,0,1
Najeeb Amar ,Hong Kong,2004,2008,4,4,1,1,1,0,0,1
Nangeyalia Kharote ,Afghanistan,2024,2024,7,7,1,1,1,0,0,1
BP Nash ,West Indies,2008,2009,9,8,1,1,1,0,0,1
SV Nayak ,India,1981,1982,4,4,1,1,1,0,0,1
Nazimuddin ,BAN,2008,2012,11,11,1,1,1,0,0,1
Neeyamur Rashid ,BAN,1999,1999,2,2,1,1,1,0,0,1
MG Neser ,Australia,2018,2023,4,4,1,1,1,0,0,1
Noor-ul-Haq ,Afghanistan,2010,2010,2,2,1,1,1,0,0,1
Noor Ahmad ,Afghanistan,2022,2024,10,10,1,1,1,0,0,1
MJ North ,Australia,2009,2009,2,2,1,1,1,0,0,1
GH O'Brien ,BER,2006,2008,9,9,1,1,1,0,0,1
IE O'Brien ,New Zealand,2008,2009,10,10,1,1,1,0,0,1
AR Odedara ,OMA,2024,2024,4,4,1,1,1,0,0,1
NM Odhiambo ,Kenya,2010,2013,8,8,1,1,1,0,0,1
NV Ojha ,India,2010,2010,1,1,1,0,0,0,1,1
LN Oluoch ,Kenya,2011,2011,2,2,1,1,1,0,0,1
G Onions ,England,2009,2009,4,4,1,1,1,0,0,1
KY Ottley ,West Indies,2021,2024,4,4,1,1,1,0,0,1
KH Pandya ,India,2021,2021,5,5,1,1,1,0,0,1
Pankaj Singh ,India,2010,2010,1,1,1,1,1,0,0,1
MHW Papps ,New Zealand,2004,2005,6,6,1,1,1,0,0,1
AA Paradkar ,United States of America,2021,2024,6,6,1,1,1,0,0,1
JS Paris ,Australia,2016,2016,2,2,1,1,1,0,0,1
NM Parker ,New Zealand,1976,1976,1,1,1,1,1,0,0,1
MW Parkinson ,England,2020,2021,5,5,1,1,1,0,0,1
Parveen Kumar ,Canada,2024,2024,2,2,1,1,1,0,0,1
AK Patel ,India,1984,1985,8,7,1,1,1,0,0,1
BP Patel ,India,1974,1979,10,10,1,1,1,0,0,1
J Patraj ,Canada,2007,2007,2,2,1,1,1,0,0,1
SG Peall ,Zimbabwe,1992,1996,21,20,1,1,1,0,0,1
AJ Penn ,New Zealand,1997,2001,5,5,1,1,1,0,0,1
AK Perera ,Sri Lanka,2013,2019,6,6,1,1,1,0,0,1
PARP Perera ,Sri Lanka,2019,2019,2,2,1,1,1,0,0,1
V Permaul ,West Indies,2012,2017,7,7,1,1,1,0,0,1
JR Philippe ,Australia,2021,2021,3,3,1,1,1,0,0,1
K Phillip ,United States of America,2021,2023,5,5,1,1,1,0,0,1
AR Pitcher ,BER,2006,2007,4,4,1,1,1,0,0,1
V Pollard ,New Zealand,1973,1974,3,3,1,1,1,0,0,1
RH Poonawala ,United Arab Emirates,1994,1994,2,2,1,1,1,0,0,1
GD Porter ,Australia,1979,1979,2,2,1,1,1,0,0,1
KTGD Prasad ,Sri Lanka,2006,2015,24,24,1,1,1,0,0,1
Pratis GC ,NEP,2023,2023,3,3,1,1,1,0,0,1
AG Puttick ,South Africa,2005,2005,1,1,1,1,1,0,0,1
Qadeer Ahmed ,United Arab Emirates,2015,2019,11,11,1,1,1,0,0,1
Rahat Ali ,Pakistan,2012,2016,14,14,1,1,1,0,0,1
P Raho ,Papau New Guinea,2014,2014,1,1,1,1,1,0,0,1
SK Ranasinghe ,Sri Lanka,1986,1986,4,4,1,1,1,0,0,1
D Ranatunga ,Sri Lanka,1990,1990,4,4,1,1,1,0,0,1
U Ranchod ,Zimbabwe,1992,1993,3,3,1,1,1,0,0,1
Raqibul Hasan ,BAN,1986,1986,2,2,1,1,1,0,0,1
JB Reva ,Papau New Guinea,2016,2018,9,9,1,1,1,0,0,1
ACL Richards ,West Indies,2007,2007,1,1,1,1,1,0,0,1
MH Richardson ,New Zealand,2002,2002,4,4,1,1,1,0,0,1
DOD Rikhi ,United States of America,2021,2021,2,2,1,1,1,0,0,1
Rizwan Ahmed ,Pakistan,2008,2008,1,1,1,1,1,0,0,1
ADG Roberts ,New Zealand,1976,1976,1,1,1,1,1,0,0,1
RJ Robinson ,BER,2007,2009,3,3,1,1,1,0,0,1
LN Roche ,Zimbabwe,2018,2018,3,3,1,1,1,0,0,1
Rokhan Barakzai ,Afghanistan,2015,2015,1,1,1,1,1,0,0,1
LC Romero ,United States of America,2004,2004,2,2,1,1,1,0,0,1
Rony Talukdar ,BAN,2023,2023,1,1,1,1,1,0,0,1
BC Rose ,England,1977,1977,2,2,1,1,1,0,0,1
MW Rushmere ,South Africa,1992,1992,4,4,1,1,1,0,0,1
SE Rutherford ,West Indies,2023,2024,9,9,1,1,1,0,0,1
Saadat Ali ,Pakistan,1984,1984,8,8,1,1,1,0,0,1
Saeed-al-Saffar ,United Arab Emirates,1996,1996,1,1,1,1,1,0,0,1
Shahbaz Ahmed ,India,2022,2022,3,3,1,1,1,0,0,1
B Sai Sudharsan ,India,2023,2023,3,3,1,1,1,0,0,1
Sajid Ali ,Pakistan,1984,1997,13,13,1,1,1,0,0,1
Saleem Altaf ,Pakistan,1973,1978,6,6,1,1,1,0,0,1
IDK Salisbury ,England,1993,1994,4,4,1,1,1,0,0,1
G Salmond ,Scotland,1999,1999,5,5,1,1,1,0,0,1
JA Samarasekera ,United Arab Emirates,1994,1996,7,7,1,1,1,0,0,1
Samiur Rahman ,BAN,1986,1986,2,2,1,1,1,0,0,1
RG Samuels ,West Indies,1996,1997,8,8,1,1,1,0,0,1
KT Sandher ,Canada,2006,2007,15,15,1,1,1,0,0,1
Sediqullah Atal ,Afghanistan,2024,2024,3,3,1,1,1,0,0,1
BB Seebaran ,Canada,2003,2003,4,4,1,1,1,0,0,1
CS Serjeant ,Australia,1977,1978,3,3,1,1,1,0,0,1
RK Sethi ,East (and Central) Africa,1975,1975,3,3,1,1,1,0,0,1
Shadab Kabir ,Pakistan,1996,1996,3,3,1,1,1,0,0,1
Shafiq Ahmed ,Pakistan,1977,1978,3,3,1,1,1,0,0,1
H Shah ,NEP,2022,2022,3,3,1,1,1,0,0,1
KD Shah ,Hong Kong,2014,2018,10,10,1,1,1,0,0,1
Shahid Ahmadzai ,Canada,2024,2024,3,3,1,1,1,0,0,1
Shahid Mahboob ,Pakistan,1982,1984,10,10,1,1,1,0,0,1
Shakeel Ahmed ,OMA,2024,2024,7,7,1,1,1,0,0,1
Shamim Hossain ,BAN,2023,2023,4,4,1,1,1,0,0,1
R Sharma ,Hong Kong,2004,2004,2,2,1,1,1,0,0,1
R Sharma ,India,2011,2012,4,4,1,1,1,0,0,1
LR Shukla ,India,1999,1999,3,3,1,1,1,0,0,1
K Shuttleworth ,England,1971,1971,1,1,1,1,1,0,0,1
B Siddharth ,OMA,2024,2024,1,1,1,1,1,0,0,1
PM Siddle ,Australia,2009,2019,20,19,1,1,1,0,0,1
RW Sims ,Zimbabwe,2002,2003,3,3,1,1,1,0,0,1
RK Singh ,India,2023,2023,2,2,1,1,1,0,0,1
L Sipamla ,South Africa,2020,2021,5,4,1,1,1,0,0,1
MA Small ,West Indies,1984,1984,2,2,1,1,1,0,0,1
JF Smith ,South Africa,2024,2024,2,2,1,1,1,0,0,1
MJ Smith ,England,1973,1974,5,5,1,1,1,0,0,1
NG Smith ,New Zealand,2024,2024,2,2,1,1,1,0,0,1
NMK Smith ,England,1996,1996,7,7,1,1,1,0,0,1
OF Smith ,West Indies,2022,2023,9,9,1,1,1,0,0,1
JA Snow ,England,1971,1975,9,8,1,1,1,0,0,1
GS Sobers ,West Indies,1973,1973,1,1,1,1,1,0,0,1
Sohail Fazal ,Pakistan,1989,1989,2,2,1,1,1,0,0,1
D Soraine ,Canada,2006,2012,4,4,1,1,1,0,0,1
M Spoors ,Canada,2023,2023,5,5,1,1,1,0,0,1
BB Sran ,India,2016,2016,6,6,1,1,1,0,0,1
L Sreekumar ,United Arab Emirates,2015,2016,4,4,1,1,1,0,0,1
S Sriram ,India,2000,2004,8,8,1,1,1,0,0,1
KR Stackpole ,Australia,1971,1974,6,6,1,1,1,0,0,1
JH Stander ,Scotland,2009,2012,5,5,1,1,1,0,0,1
B Stanlake ,Australia,2017,2019,7,7,1,1,1,0,0,1
LW Stokkers ,NED,2008,2008,1,1,1,1,1,0,0,1
LW Stott ,New Zealand,1979,1979,1,1,1,1,1,0,0,1
CEL Stuart ,West Indies,2001,2001,5,5,1,1,1,0,0,1
ML Su'a ,New Zealand,1992,1995,12,12,1,1,1,0,0,1
R Sudhakar Rao ,India,1976,1976,1,1,1,1,1,0,0,1
JTS Sumerauer ,JER,2023,2023,5,5,1,1,1,0,0,1
W Sutherland ,Australia,2024,2024,2,2,1,1,1,0,0,1
Syed Maqsood ,United Arab Emirates,2004,2004,2,2,1,1,1,0,0,1
Talha Jubair ,BAN,2002,2003,6,6,1,1,1,0,0,1
Tanbir Hayder ,BAN,2016,2016,2,2,1,1,1,0,0,1
Tanvir Ahmed ,Pakistan,2011,2011,2,2,1,1,1,0,0,1
Tanzim Hasan Sakib ,BAN,2023,2024,7,7,1,1,1,0,0,1
BR Taylor ,New Zealand,1973,1973,2,2,1,1,1,0,0,1
O Thomas ,West Indies,2018,2024,25,24,1,1,1,0,0,1
GJ Thompson ,Ireland,2008,2008,3,3,1,1,1,0,0,1
NT Tilak Varma ,India,2023,2023,4,4,1,1,1,0,0,1
FJ Titmus ,England,1975,1975,2,2,1,1,1,0,0,1
RW Tolchard ,England,1979,1979,1,1,1,1,0,1,0,1
CP Tremain ,Australia,2016,2016,4,4,1,1,1,0,0,1
JO Troughton ,England,2003,2003,6,5,1,1,1,0,0,1
AJ Tudor ,England,2002,2002,3,3,1,1,1,0,0,1
S Tyagi ,India,2009,2010,4,4,1,1,1,0,0,1
AJ Tye ,Australia,2018,2018,7,7,1,1,1,0,0,1
SD Udal ,England,1994,2005,11,11,1,1,1,0,0,1
Umair Ali ,United Arab Emirates,2015,2015,2,2,1,1,1,0,0,1
ARI Umeed ,Scotland,2024,2024,5,5,1,1,1,0,0,1
JD Unadkat ,India,2013,2023,8,8,1,1,1,0,0,1
Usman Qadir ,Pakistan,2021,2021,1,1,1,1,1,0,0,1
Usman Salahuddin ,Pakistan,2011,2011,2,2,1,1,1,0,0,1
JN Valentine ,Canada,1979,1979,3,3,1,1,1,0,0,1
T van der Gugten ,NED,2012,2024,12,12,1,1,1,0,0,1
A van der Merwe ,Ireland,2010,2011,9,9,1,1,1,0,0,1
VB van Jaarsveld ,South Africa,2009,2009,2,2,1,1,1,0,0,1
TF van Woerkom ,Ireland,2023,2024,4,4,1,1,1,0,0,1
S Vesawkar ,NEP,2018,2021,4,4,1,1,1,0,0,1
AL Wadekar ,India,1974,1974,2,2,1,1,1,0,0,1
I Wardlaw ,Scotland,2013,2015,22,21,1,1,1,0,0,1
SR Welsh ,Canada,2006,2008,3,3,1,1,1,0,0,1
BA Westdijk ,NED,2011,2011,4,4,1,1,1,0,0,1
AG Wharf ,England,2004,2005,13,13,1,1,1,0,0,1
BM Wheeler ,New Zealand,2015,2015,6,6,1,1,1,0,0,1
JJ Whitaker ,England,1987,1987,2,2,1,1,1,0,0,1
DJ White ,New Zealand,1990,1990,3,3,1,1,1,0,0,1
P Wilson ,Australia,1997,1998,11,11,1,1,1,0,0,1
WA Wisneski ,New Zealand,2000,2000,3,3,1,1,1,0,0,1
DJ Worrall ,Australia,2016,2016,3,3,1,1,1,0,0,1
CM Wright ,Scotland,2006,2009,20,20,1,1,1,0,0,1
M Yachad ,South Africa,1991,1991,1,1,1,1,1,0,0,1
J Yadav ,India,2016,2022,2,2,1,1,1,0,0,1
NS Yadav ,India,1986,1987,7,7,1,1,1,0,0,1
B Yardley ,Australia,1978,1983,7,5,1,1,1,0,0,1
Yasir Mohammad ,United States of America,2022,2024,6,6,1,1,1,0,0,1
Younis Ahmed ,Pakistan,1987,1987,2,2,1,1,1,0,0,1
Zafar Iqbal ,Pakistan,1995,1995,8,8,1,1,1,0,0,1
Zahid Hussain ,Canada,2011,2011,2,2,1,1,1,0,0,1
Zakir Hasan ,BAN,2023,2024,2,2,1,1,1,0,0,1
Sultan Zarawani ,United Arab Emirates,1994,1996,7,7,1,1,1,0,0,1
Zawar Farid ,United Arab Emirates,2020,2023,10,10,1,1,1,0,0,1
AK Zesers ,Australia,1987,1987,2,2,1,1,1,0,0,1
C Zhuwao ,Zimbabwe,2008,2018,9,9,1,1,1,0,0,1
K Zondo ,South Africa,2018,2021,6,6,1,1,1,0,0,1
Zulfiqar Ali ,East (and Central) Africa,1975,1975,3,3,1,1,1,0,0,1
ME Sanuth ,OMA,2020,2020,3,3,0,0,0,0,0,0
Aamer Hanif ,Pakistan,1993,1995,5,5,0,0,0,0,0,0
Aamer Nazir ,Pakistan,1993,1995,9,9,0,0,0,0,0,0
Aamer Yamin ,Pakistan,2015,2018,4,4,0,0,0,0,0,0
Abdul Malik (1) ,Afghanistan,2024,2024,1,1,0,0,0,0,0,0
Abdul Rahman ,Afghanistan,2023,2023,3,3,0,0,0,0,0,0
Abdul Rehman ,United Arab Emirates,2004,2004,1,1,0,0,0,0,0,0
S Abid Ali ,India,1974,1975,5,5,0,0,0,0,0,0
Abu Jayed ,BAN,2019,2019,2,2,0,0,0,0,0,0
WA Agar ,Australia,2021,2021,2,2,0,0,0,0,0,0
FS Ahangama ,Sri Lanka,1985,1985,1,1,0,0,0,0,0,0
Ahmed Kamal ,BAN,1999,1999,1,1,0,0,0,0,0,0
Ahmed Shah ,Afghanistan,2009,2009,1,1,0,0,0,0,0,0
KS Airee ,NEP,2020,2022,3,3,0,0,0,0,0,0
Akhtar Sarfraz ,Pakistan,1997,1998,4,4,0,0,0,0,0,0
Alawi Shukri ,United Arab Emirates,2008,2008,1,1,0,0,0,0,0,0
GW Aldridge ,New Zealand,2011,2011,2,2,0,0,0,0,0,0
RP Alexander ,United States of America,2004,2004,2,2,0,0,0,0,0,0
Ali Asad ,United Arab Emirates,2004,2004,2,2,0,0,0,0,0,0
KN Amalean ,Sri Lanka,1986,1988,8,8,0,0,0,0,0,0
Aman Ali ,United Arab Emirates,2008,2008,1,1,0,0,0,0,0,0
Aminul Islam jnr ,BAN,1999,1999,1,1,0,0,0,0,0,0
Ammar Khalid ,Canada,2024,2024,4,4,0,0,0,0,0,0
J Andrew ,West Indies,2024,2024,1,1,0,0,0,0,0,0
J Angel ,Australia,1994,1995,3,3,0,0,0,0,0,0
Anisur Rahman ,BAN,1995,1998,2,2,0,0,0,0,0,0
ZS Ansari ,England,2015,2015,1,1,0,0,0,0,0,0
Ansh Tandon ,United Arab Emirates,2023,2023,1,1,0,0,0,0,0,0
HAG Anthony ,West Indies,1995,1995,3,3,0,0,0,0,0,0
Anwar Hossain Monir ,BAN,2002,2002,1,1,0,0,0,0,0,0
Anwar Hossain ,BAN,2002,2002,1,1,0,0,0,0,0,0
GJAF Aponso ,NED,1996,1996,5,5,0,0,0,0,0,0
MA Aponso ,Sri Lanka,2016,2018,9,9,0,0,0,0,0,0
Ariful Haque ,BAN,2018,2018,1,1,0,0,0,0,0,0
Arshad Pervez ,Pakistan,1978,1978,2,2,0,0,0,0,0,0
B Arun ,India,1986,1987,4,4,0,0,0,0,0,0
Asad Ali ,Pakistan,2013,2013,4,4,0,0,0,0,0,0
Asghar Ali ,United Arab Emirates,2004,2004,2,2,0,0,0,0,0,0
Ashfaq Ahmed ,Pakistan,1994,1994,3,3,0,0,0,0,0,0
Asif Iqbal (1) ,United Arab Emirates,2015,2015,1,1,0,0,0,0,0,0
Asif Mahmood ,Pakistan,1998,1998,2,2,0,0,0,0,0,0
Asim Butt ,Scotland,1999,1999,5,5,0,0,0,0,0,0
Asim Saeed ,United Arab Emirates,2004,2004,2,2,0,0,0,0,0,0
Ata-ur-Rehman ,Pakistan,1992,1996,30,30,0,0,0,0,0,0
ID Austin ,England,1998,1999,9,9,0,0,0,0,0,0
RA Austin ,West Indies,1978,1978,1,1,0,0,0,0,0,0
Azmat Rana ,Pakistan,1978,1978,2,2,0,0,0,0,0,0
MD Bailey ,New Zealand,1998,1998,1,1,0,0,0,0,0,0
DS Bajwa ,Canada,2024,2024,6,6,0,0,0,0,0,0
G Bajwa ,Canada,2024,2024,1,1,0,0,0,0,0,0
PJ Bakker ,NED,1996,1996,5,5,0,0,0,0,0,0
S Baksh ,Canada,1979,1979,1,1,0,0,0,0,0,0
KMC Bandara ,Sri Lanka,2016,2016,1,1,0,0,0,0,0,0
MRCN Bandaratilleke ,Sri Lanka,1998,1998,3,3,0,0,0,0,0,0
OAC Banks ,West Indies,2003,2005,5,5,0,0,0,0,0,0
KJ Barnett ,England,1988,1988,1,1,0,0,0,0,0,0
XC Bartlett ,Australia,2024,2024,2,2,0,0,0,0,0,0
DM Basden ,BER,2007,2007,2,2,0,0,0,0,0,0
Basir Ahamad ,NEP,2022,2022,3,3,0,0,0,0,0,0
GR Beard ,Australia,1981,1981,2,2,0,0,0,0,0,0
RR Beaton ,West Indies,2017,2017,2,2,0,0,0,0,0,0
JE Benjamin ,England,1994,1995,2,2,0,0,0,0,0,0
MR Benson ,England,1986,1986,1,1,0,0,0,0,0,0
A Bhandari ,India,2000,2004,2,2,0,0,0,0,0,0
LS Bhandari ,NEP,2018,2018,1,1,0,0,0,0,0,0
RN Bhatia ,United Arab Emirates,2022,2024,9,9,0,0,0,0,0,0
Bhupinder Singh snr ,India,1994,1994,2,2,0,0,0,0,0,0
D Birrell ,JER,2023,2023,1,1,0,0,0,0,0,0
TJ Bishop ,West Indies,2024,2024,1,1,0,0,0,0,0,0
MI Black ,West Indies,2001,2001,5,5,0,0,0,0,0,0
DL Blake ,United States of America,2004,2004,1,1,0,0,0,0,0,0
G Blakeney ,BER,2009,2009,2,2,0,0,0,0,0,0
DG Blampied ,JER,2023,2023,3,3,0,0,0,0,0,0
PD Blignaut ,Namibia,2024,2024,1,1,0,0,0,0,0,0
A Bohara ,NEP,2020,2020,2,2,0,0,0,0,0,0
SG Borthwick ,England,2011,2011,2,2,0,0,0,0,0,0
T Bosch ,South Africa,1992,1992,2,2,0,0,0,0,0,0
GK Bose ,India,1974,1974,1,1,0,0,0,0,0,0
KD Boyce ,West Indies,1973,1975,8,8,0,0,0,0,0,0
BP Bracewell ,New Zealand,1978,1978,1,1,0,0,0,0,0,0
GA Briant ,Zimbabwe,1993,1993,5,5,0,0,0,0,0,0
DR Briggs ,England,2012,2012,1,1,0,0,0,0,0,0
SA Britton ,Ireland,2009,2009,1,1,0,0,0,0,0,0
D Brown ,West Indies,2001,2002,3,3,0,0,0,0,0,0
BS Browne ,West Indies,1994,1994,4,4,0,0,0,0,0,0
GK Bruk-Jackson ,Zimbabwe,1993,1993,1,1,0,0,0,0,0,0
AJ Burger ,Namibia,2003,2003,6,6,0,0,0,0,0,0
N Burger ,South Africa,2023,2024,5,5,0,0,0,0,0,0
AR Butcher ,England,1980,1980,1,1,0,0,0,0,0,0
RO Butcher ,England,1980,1981,3,3,0,0,0,0,0,0
DK Butler ,West Indies,2005,2006,5,5,0,0,0,0,0,0
RG Callender ,Canada,1979,1979,2,2,0,0,0,0,0,0
JD Campbell ,West Indies,2019,2019,6,5,0,0,0,0,0,0
PE Cantrell ,NED,1996,1996,5,5,0,0,0,0,0,0
PH Carlson ,Australia,1979,1979,4,3,0,0,0,0,0,0
HL Carlyon ,JER,2023,2023,5,5,0,0,0,0,0,0
NM Carter ,Scotland,2013,2013,3,3,0,0,0,0,0,0
C Cassell ,Scotland,2024,2024,2,2,0,0,0,0,0,0
RD Chahar ,India,2021,2021,1,1,0,0,0,0,0,0
SJ Chalmers ,Scotland,2009,2009,2,2,0,0,0,0,0,0
BS Chandrasekhar ,India,1976,1976,1,1,0,0,0,0,0,0
VB Chandrasekhar ,India,1988,1990,7,7,0,0,0,0,0,0
CJD Chappell ,Canada,1979,1979,3,3,0,0,0,0,0,0
G Chapple ,England,2006,2006,1,1,0,0,0,0,0,0
M Cheruparambil ,Hong Kong,2004,2004,2,2,0,0,0,0,0,0
MT Chinouya ,Zimbabwe,2013,2013,2,2,0,0,0,0,0,0
K Christie ,Hong Kong,2016,2016,1,1,0,0,0,0,0,0
WM Clark ,Australia,1978,1978,2,2,0,0,0,0,0,0
A Codrington ,Canada,2003,2007,9,9,0,0,0,0,0,0
DJ Colley ,Australia,1972,1972,1,1,0,0,0,0,0,0
BE Congdon ,New Zealand,1973,1978,11,11,0,0,0,0,0,0
AN Connolly ,Australia,1971,1971,1,1,0,0,0,0,0,0
C Connolly ,Australia,2024,2024,2,2,0,0,0,0,0,0
GA Cope ,England,1977,1978,2,2,0,0,0,0,0,0
MJ Cosgrove ,Australia,2006,2006,3,3,0,0,0,0,0,0
CS Cowdrey ,England,1985,1985,3,3,0,0,0,0,0,0
MC Cowdrey ,England,1971,1971,1,1,0,0,0,0,0,0
RT Crandon ,West Indies,2009,2009,1,1,0,0,0,0,0,0
FS Crockwell ,BER,2009,2009,2,2,0,0,0,0,0,0
SW Currie ,Scotland,2024,2024,3,3,0,0,0,0,0,0
S Daniel ,Sri Lanka,2024,2024,1,1,0,0,0,0,0,0
Danish Aziz ,Pakistan,2021,2021,2,2,0,0,0,0,0,0
SS Das ,India,2001,2002,4,4,0,0,0,0,0,0
NA David ,India,1997,1997,4,4,0,0,0,0,0,0
RR David ,Canada,2008,2010,4,4,0,0,0,0,0,0
TH David ,Australia,2023,2023,4,4,0,0,0,0,0,0
H Davids ,South Africa,2013,2013,2,1,0,0,0,0,0,0
JJ Davidson ,Scotland,2024,2024,2,2,0,0,0,0,0,0
O Davidson ,Scotland,2022,2022,1,1,0,0,0,0,0,0
SG Davies ,Zimbabwe,1996,1996,4,4,0,0,0,0,0,0
IC Davis ,Australia,1974,1977,3,3,0,0,0,0,0,0
Dawlat Ahmadzai ,Afghanistan,2009,2010,3,3,0,0,0,0,0,0
JJ Dawood ,Canada,2009,2010,2,1,0,0,0,0,0,0
NA de Groot ,Canada,2003,2003,6,6,0,0,0,0,0,0
M de Lange ,South Africa,2012,2016,4,4,0,0,0,0,0,0
FA Dennis ,Canada,1979,1979,3,3,0,0,0,0,0,0
GN de Silva ,Sri Lanka,1983,1985,4,4,0,0,0,0,0,0
JI de Villiers ,Namibia,2020,2024,4,4,0,0,0,0,0,0
T de Zorzi ,South Africa,2023,2024,9,9,0,0,0,0,0,0
R Dhakal ,NEP,2024,2024,3,2,0,0,0,0,0,0
S Dhamala ,NEP,2022,2022,1,1,0,0,0,0,0,0
H Dhami ,NEP,2024,2024,1,1,0,0,0,0,0,0
P Dharmani ,India,1996,1996,1,1,0,0,0,0,0,0
R Dhawan ,India,2016,2016,3,3,0,0,0,0,0,0
HS Dhillon ,Canada,2006,2006,2,2,0,0,0,0,0,0
WP Diepeveen ,NED,2011,2011,1,1,0,0,0,0,0,0
Dolar Mahmud ,BAN,2008,2009,7,7,0,0,0,0,0,0
BR Dorey ,Australia,2006,2006,4,4,0,0,0,0,0,0
CRM Douglas ,BER,2008,2008,2,2,0,0,0,0,0,0
SO Dowrich ,West Indies,2019,2019,1,1,0,0,0,0,0,0
J Drysdale ,United States of America,2024,2024,4,4,0,0,0,0,0,0
JA Duffy ,New Zealand,2022,2024,8,8,0,0,0,0,0,0
DM Dupavillon ,South Africa,2020,2021,2,2,0,0,0,0,0,0
BJ Dwarshuis ,Australia,2024,2024,1,1,0,0,0,0,0,0
PS Eaglestone ,Ireland,2008,2008,1,1,0,0,0,0,0,0
JH Edrich ,England,1971,1975,7,7,0,0,0,0,0,0
R Edwards ,Australia,1972,1975,9,9,0,0,0,0,0,0
WJ Edwards ,Australia,1975,1975,1,1,0,0,0,0,0,0
Ehsanul Haque ,BAN,2002,2003,6,6,0,0,0,0,0,0
Ehsan Adil ,Pakistan,2013,2015,6,6,0,0,0,0,0,0
Elias Sunny ,BAN,2011,2012,4,4,0,0,0,0,0,0
MTG Elliott ,Australia,1997,1997,1,1,0,0,0,0,0,0
Fahad Alhashmi ,United Arab Emirates,2008,2015,5,5,0,0,0,0,0,0
Fahad Nawaz ,United Arab Emirates,2019,2019,2,2,0,0,0,0,0,0
Faisal Athar ,Pakistan,2003,2003,1,1,0,0,0,0,0,0
Fawad Ahmed ,Australia,2013,2013,3,3,0,0,0,0,0,0
Fayyaz Ahmed ,United Arab Emirates,2014,2016,3,3,0,0,0,0,0,0
FY Fazal ,India,2016,2016,1,1,0,0,0,0,0,0
Fazl-e-Akbar ,Pakistan,1998,2001,2,2,0,0,0,0,0,0
N Fernandes ,United Arab Emirates,2008,2008,1,1,0,0,0,0,0,0
ER Fernando ,Sri Lanka,1975,1975,3,3,0,0,0,0,0,0
ERNS Fernando ,Sri Lanka,1983,1983,7,7,0,0,0,0,0,0
KNM Fernando ,Sri Lanka,2024,2024,3,3,0,0,0,0,0,0
MNK Fernando ,Sri Lanka,2023,2024,5,5,0,0,0,0,0,0
MVT Fernando ,Sri Lanka,2017,2019,8,8,0,0,0,0,0,0
TL Fernando ,Sri Lanka,1989,1989,1,1,0,0,0,0,0,0
UNK Fernando ,Sri Lanka,1994,1994,2,2,0,0,0,0,0,0
R Flannigan ,Scotland,2010,2010,1,1,0,0,0,0,0,0
DAG Fletcher ,Zimbabwe,1983,1983,6,6,0,0,0,0,0,0
BC Fortuin ,South Africa,2020,2024,11,10,0,0,0,0,0,0
MLC Foster ,West Indies,1973,1973,2,2,0,0,0,0,0,0
D Foxcroft ,New Zealand,2023,2023,1,1,0,0,0,0,0,0
TJ Franklin ,New Zealand,1983,1988,3,3,0,0,0,0,0,0
Frasat Ali ,East (and Central) Africa,1975,1975,3,3,0,0,0,0,0,0
IS Gallage ,Sri Lanka,1999,2001,3,3,0,0,0,0,0,0
DJ Gandhi ,India,1999,2000,3,3,0,0,0,0,0,0
D Ganesh ,India,1997,1997,1,1,0,0,0,0,0,0
LV Garrick ,West Indies,2001,2001,3,3,0,0,0,0,0,0
WT Gavera ,Papau New Guinea,2014,2017,4,4,0,0,0,0,0,0
RS Ghai ,India,1984,1986,6,6,0,0,0,0,0,0
Gholam Nousher ,BAN,1986,1990,9,9,0,0,0,0,0,0
Ghulam Ali ,Pakistan,1993,1995,3,3,0,0,0,0,0,0
T Gibbons ,BER,2006,2006,2,2,0,0,0,0,0,0
LR Gibbs ,West Indies,1973,1975,3,3,0,0,0,0,0,0
PG Gillespie ,Ireland,2006,2007,5,5,0,0,0,0,0,0
Golam Faruq ,BAN,1986,1990,5,5,0,0,0,0,0,0
MS Gony ,India,2008,2008,2,2,0,0,0,0,0,0
Y Goonasekera ,Sri Lanka,1983,1983,3,3,0,0,0,0,0,0
BHG Gorlee ,NED,2022,2022,3,3,0,0,0,0,0,0
EL Gouka ,NED,1996,1996,3,3,0,0,0,0,0,0
VD Grandia ,NED,2002,2002,1,1,0,0,0,0,0,0
AE Greenidge ,West Indies,1978,1978,1,1,0,0,0,0,0,0
L Gregory ,England,2021,2021,3,3,0,0,0,0,0,0
RD Gudhka ,Kenya,2011,2011,2,2,0,0,0,0,0,0
C Gunasekara ,Sri Lanka,2022,2022,1,1,0,0,0,0,0,0
FRMD Gunatilleke ,Sri Lanka,1979,1979,1,1,0,0,0,0,0,0
AAW Gunawardena ,Sri Lanka,1994,1994,1,1,0,0,0,0,0,0
SK Gupta ,Kenya,1996,2001,10,10,0,0,0,0,0,0
Gurdeep Singh ,Kenya,2013,2013,1,1,0,0,0,0,0,0
Haafiz Shahid ,Pakistan,1988,1988,3,3,0,0,0,0,0,0
BG Hadlee ,New Zealand,1975,1975,2,2,0,0,0,0,0,0
SR Hain ,England,2023,2023,2,1,0,0,0,0,0,0
OJ Hairs ,Scotland,2010,2010,5,5,0,0,0,0,0,0
JD Hall ,Ireland,2010,2010,3,3,0,0,0,0,0,0
JN Hamilton ,West Indies,2021,2021,1,1,0,0,0,0,0,0
LJ Hamilton ,New Zealand,2005,2005,2,2,0,0,0,0,0,0
JR Hammond ,Australia,1972,1972,1,1,0,0,0,0,0,0
JH Hampshire ,England,1971,1972,3,3,0,0,0,0,0,0
F Hand ,Ireland,2024,2024,1,1,0,0,0,0,0,0
KJ Harding ,West Indies,2021,2021,1,1,0,0,0,0,0,0
Harilal Shah ,East (and Central) Africa,1975,1975,3,3,0,0,0,0,0,0
RT Hart ,New Zealand,1985,1985,1,1,0,0,0,0,0,0
TW Hartley ,England,2023,2023,2,1,0,0,0,0,0,0
Harunur Rashid ,BAN,1988,1988,2,2,0,0,0,0,0,0
SM Harwood ,Australia,2009,2009,1,1,0,0,0,0,0,0
MJ Haslam ,New Zealand,1992,1992,1,1,0,0,0,0,0,0
Hasti Gul ,Afghanistan,2009,2009,2,2,0,0,0,0,0,0
AW Hawkins-Kay ,JER,2023,2023,1,1,0,0,0,0,0,0
FC Hayes ,England,1973,1975,6,5,0,0,0,0,0,0
RL Hayes ,New Zealand,1995,1995,1,1,0,0,0,0,0,0
Hazrat Bilal ,United Arab Emirates,2022,2023,7,7,0,0,0,0,0,0
RGA Headley ,West Indies,1973,1973,1,1,0,0,0,0,0,0
SD Heazlett ,Australia,2017,2017,1,1,0,0,0,0,0,0
CW Henderson ,South Africa,2001,2001,4,4,0,0,0,0,0,0
CC Henry ,Canada,1979,1979,2,2,0,0,0,0,0,0
KAR Hodge ,West Indies,2023,2024,4,4,0,0,0,0,0,0
VR Hogg ,Zimbabwe,1983,1983,2,2,0,0,0,0,0,0
CK Holder ,West Indies,2021,2021,1,1,0,0,0,0,0,0
RG Holland ,Australia,1985,1985,2,2,0,0,0,0,0,0
DAW Hollis ,BER,2008,2008,1,1,0,0,0,0,0,0
PA Horne ,New Zealand,1987,1987,4,4,0,0,0,0,0,0
MJ Humphreys ,Ireland,2023,2024,3,3,0,0,0,0,0,0
Hussain Talat ,Pakistan,2019,2019,1,1,0,0,0,0,0,0
Ihsanullah ,Pakistan,2023,2023,1,1,0,0,0,0,0,0
Ilyas Gull ,Hong Kong,2004,2004,2,2,0,0,0,0,0,0
Intikhab Alam ,Pakistan,1973,1976,4,4,0,0,0,0,0,0
Iqbal Sikander ,Pakistan,1992,1992,4,4,0,0,0,0,0,0
Irfan Fazil ,Pakistan,2000,2000,1,1,0,0,0,0,0,0
Irfan Sajid ,United Arab Emirates,2014,2014,1,1,0,0,0,0,0,0
Ishtiaq Muhammad ,Hong Kong,2016,2016,1,1,0,0,0,0,0,0
VR Iyer ,India,2022,2022,2,2,0,0,0,0,0,0
W Jaffer ,India,2006,2006,2,2,0,0,0,0,0,0
Jahangir Alam Talukdar ,BAN,1990,1990,2,2,0,0,0,0,0,0
JA Jameson ,England,1973,1975,3,3,0,0,0,0,0,0
RM Jariwala ,United States of America,2022,2022,4,4,0,0,0,0,0,0
Jawahir Shah ,East (and Central) Africa,1975,1975,3,3,0,0,0,0,0,0
PS Jayaprakashdaran ,Sri Lanka,2005,2005,1,1,0,0,0,0,0,0
RSA Jayasekera ,Sri Lanka,1982,1982,2,2,0,0,0,0,0,0
NGRP Jayasuriya ,Sri Lanka,2018,2018,2,2,0,0,0,0,0,0
P Jayawickrama ,Sri Lanka,2021,2021,5,5,0,0,0,0,0,0
TJ Jenner ,Australia,1975,1975,1,1,0,0,0,0,0,0
KCB Jeremy ,West Indies,2000,2001,6,6,0,0,0,0,0,0
K Jethi ,Canada,2008,2008,3,3,0,0,0,0,0,0
HR Johnson ,United States of America,2004,2004,2,2,0,0,0,0,0,0
RL Johnson ,England,2003,2003,10,9,0,0,0,0,0,0
SH Johnson ,Australia,2023,2024,2,2,0,0,0,0,0,0
RA Jones ,New Zealand,2003,2003,5,5,0,0,0,0,0,0
SP Jones ,England,2004,2005,8,8,0,0,0,0,0,0
C Jonker ,South Africa,2018,2018,2,2,0,0,0,0,0,0
D Joseph ,Canada,2003,2003,4,4,0,0,0,0,0,0
S Joseph ,West Indies,2024,2024,1,1,0,0,0,0,0,0
RR Joshi ,Canada,2024,2024,1,1,0,0,0,0,0,0
Junaid Zia ,Pakistan,2003,2003,4,4,0,0,0,0,0,0
R Kaia ,Zimbabwe,2015,2015,1,1,0,0,0,0,0,0
AV Kale ,India,2003,2003,1,1,0,0,0,0,0,0
LWS Kaluperuma ,Sri Lanka,1975,1982,4,4,0,0,0,0,0,0
Kamran Ghulam ,Pakistan,2023,2024,4,4,0,0,0,0,0,0
Kamran Hussain ,Pakistan,2008,2008,2,2,0,0,0,0,0,0
K Kamyuka ,Canada,2013,2013,2,2,0,0,0,0,0,0
AL Kandappah ,Canada,2007,2007,2,2,0,0,0,0,0,0
MG Kariata ,Namibia,2024,2024,1,1,0,0,0,0,0,0
J Kariko ,Papau New Guinea,2023,2023,3,3,0,0,0,0,0,0
Karim Janat ,Afghanistan,2017,2023,3,3,0,0,0,0,0,0
Kashif Raza ,Pakistan,2001,2001,1,1,0,0,0,0,0,0
F Kasteni ,Zimbabwe,2007,2007,3,3,0,0,0,0,0,0
E Katchay ,Canada,2008,2009,5,5,0,0,0,0,0,0
PHT Kaushal ,Sri Lanka,2015,2015,1,1,0,0,0,0,0,0
RWT Key ,England,2003,2004,5,5,0,0,0,0,0,0
Khalid Khan ,Hong Kong,2004,2004,2,2,0,0,0,0,0,0
Khaliq Dad ,Afghanistan,2009,2010,6,6,0,0,0,0,0,0
GK Khoda ,India,1998,1998,2,2,0,0,0,0,0,0
CK Kruger ,Hong Kong,2008,2008,2,2,0,0,0,0,0,0
MB Kruger ,Namibia,2024,2024,8,8,0,0,0,0,0,0
SC Kuggeleijn ,New Zealand,2017,2017,2,2,0,0,0,0,0,0
Akhil Kumar ,Canada,2024,2024,3,3,0,0,0,0,0,0
MKGCP Lakshitha ,Sri Lanka,2002,2003,7,7,0,0,0,0,0,0
AV Lalcheta ,OMA,2019,2019,2,2,0,0,0,0,0,0
SB Lama ,Hong Kong,2004,2004,1,1,0,0,0,0,0,0
GA Lamb ,Zimbabwe,2010,2011,15,15,0,0,0,0,0,0
CB Lambert (USA/WI),NA,1990,2004,12,12,0,0,0,0,0,0
TJ Laughlin ,Australia,1978,1979,6,6,0,0,0,0,0,0
DV Lawrence ,England,1991,1991,1,1,0,0,0,0,0,0
JJC Lawson ,West Indies,2001,2005,13,12,0,0,0,0,0,0
J Lewis ,England,2005,2007,13,13,0,0,0,0,0,0
Liaqat Ali ,Pakistan,1977,1978,3,3,0,0,0,0,0,0
GFJ Liebenberg ,South Africa,1995,1998,4,4,0,0,0,0,0,0
BG Lister ,New Zealand,2023,2023,3,3,0,0,0,0,0,0
TA Lloyd ,England,1984,1984,3,3,0,0,0,0,0,0
CH Lonsdale ,BER,2007,2007,1,1,0,0,0,0,0,0
AGR Loudon ,England,2006,2006,1,1,0,0,0,0,0,0
J Louw ,South Africa,2008,2008,3,3,0,0,0,0,0,0
MB Loye ,England,2007,2007,7,7,0,0,0,0,0,0
BW Luckhurst ,England,1975,1975,3,3,0,0,0,0,0,0
AM McCarthy ,West Indies,2021,2021,2,2,0,0,0,0,0,0
C McAuslan ,Hong Kong,2017,2017,2,2,0,0,0,0,0,0
OC McCoy ,West Indies,2018,2018,2,2,0,0,0,0,0,0
BR McDermott ,Australia,2021,2022,5,5,0,0,0,0,0,0
PD Machhi ,OMA,2021,2021,1,1,0,0,0,0,0,0
JA Maclean ,Australia,1979,1979,2,1,0,0,0,0,0,0
H McLeod ,East (and Central) Africa,1975,1975,2,2,0,0,0,0,0,0
NJ MacRae ,Scotland,2006,2006,2,2,0,0,0,0,0,0
DSK Madushanka ,Sri Lanka,2018,2018,1,1,0,0,0,0,0,0
LD Madushanka ,Sri Lanka,2017,2017,4,4,0,0,0,0,0,0
K Mahato ,NEP,2022,2023,2,2,0,0,0,0,0,0
Mahbubur Rahman ,BAN,1999,1999,1,1,0,0,0,0,0,0
Mahmood Hamid ,Pakistan,1995,1995,1,1,0,0,0,0,0,0
AV Mankad ,India,1974,1974,1,1,0,0,0,0,0,0
Mansoor Amjad ,Pakistan,2008,2008,1,1,0,0,0,0,0,0
Mansoor Rana ,Pakistan,1990,1990,2,2,0,0,0,0,0,0
Maqsood Rana ,Pakistan,1990,1990,1,1,0,0,0,0,0,0
CA Marshall ,Canada,1979,1979,2,2,0,0,0,0,0,0
JAH Marshall ,New Zealand,2005,2008,10,10,0,0,0,0,0,0
GC Martin ,Zimbabwe,1994,1995,5,5,0,0,0,0,0,0
Masood Iqbal ,Pakistan,1984,1984,1,1,0,0,0,0,0,0
SJ Massiah ,United States of America,2004,2004,2,2,0,0,0,0,0,0
PS Masvaure ,Zimbabwe,2018,2018,2,2,0,0,0,0,0,0
AW Mathieson ,New Zealand,2015,2015,1,1,0,0,0,0,0,0
Matiullah Khan ,United Arab Emirates,2023,2023,1,1,0,0,0,0,0,0
BM Mauricette ,Canada,1979,1979,3,3,0,0,0,0,0,0
DES Maxwell ,Canada,2006,2007,10,10,0,0,0,0,0,0
Mazharul Haque ,BAN,2002,2002,1,1,0,0,0,0,0,0
GJ McCarter ,Ireland,2014,2014,1,1,0,0,0,0,0,0
SC Meaker ,England,2011,2011,2,2,0,0,0,0,0,0
Mehmood Quaraishy ,East (and Central) Africa,1975,1975,3,3,0,0,0,0,0,0
Mehran Khan ,OMA,2024,2024,4,4,0,0,0,0,0,0
PS Mehta ,East (and Central) Africa,1975,1975,1,1,0,0,0,0,0,0
MA Meman ,Zimbabwe,1987,1987,1,1,0,0,0,0,0,0
JM Mennie ,Australia,2016,2016,2,2,0,0,0,0,0,0
RP Meredith ,Australia,2021,2021,1,1,0,0,0,0,0,0
PL Mhambrey ,India,1996,1998,3,3,0,0,0,0,0,0
EJB Miles ,JER,2023,2023,4,4,0,0,0,0,0,0
Mohammad Abbas ,Pakistan,2019,2019,3,3,0,0,0,0,0,0
Mohammad Aslam ,United Arab Emirates,1996,1996,4,4,0,0,0,0,0,0
Mohammad Iqbal ,Canada,2007,2008,5,5,0,0,0,0,0,0
Mohammad Nazir ,Pakistan,1980,1984,4,4,0,0,0,0,0,0
Mohammad Talha ,Pakistan,2014,2014,3,3,0,0,0,0,0,0
Moin-ul-Atiq ,Pakistan,1988,1989,5,5,0,0,0,0,0,0
Moniruzzaman ,BAN,2003,2003,2,2,0,0,0,0,0,0
DWO Morgan ,BER,2006,2006,2,2,0,0,0,0,0,0
EA Moseley ,West Indies,1990,1991,9,8,0,0,0,0,0,0
PV Mpitsang ,South Africa,1999,1999,2,2,0,0,0,0,0,0
T Mufudza ,Zimbabwe,2024,2024,2,2,0,0,0,0,0,0
Muhammad Musa ,Pakistan,2020,2020,2,2,0,0,0,0,0,0
Mujahid Jamshed ,Pakistan,1997,1997,4,4,0,0,0,0,0,0
M Mulla ,Canada,2007,2007,1,1,0,0,0,0,0,0
AMN Munasinghe ,Sri Lanka,1994,1996,5,5,0,0,0,0,0,0
Munir Dar ,Hong Kong,2008,2008,2,2,0,0,0,0,0,0
GB Murgatroyd ,Namibia,2003,2003,6,6,0,0,0,0,0,0
DJ Murray ,New Zealand,1994,1994,1,1,0,0,0,0,0,0
T Muzarabani ,Zimbabwe,2015,2016,8,8,0,0,0,0,0,0
Nadeem Ghauri ,Pakistan,1990,1990,6,6,0,0,0,0,0,0
Nadeem Khan ,Pakistan,1993,1995,2,2,0,0,0,0,0,0
Naeem Ashraf ,Pakistan,1995,1995,2,2,0,0,0,0,0,0
J Nagenda ,East (and Central) Africa,1975,1975,1,1,0,0,0,0,0,0
Nahid Rana ,BAN,2024,2024,1,1,0,0,0,0,0,0
SS Naik ,India,1974,1974,2,2,0,0,0,0,0,0
KK Nair ,India,2016,2016,2,2,0,0,0,0,0,0
Najaf Shah ,Pakistan,2007,2007,1,1,0,0,0,0,0,0
Najeeb Tarakai ,Afghanistan,2017,2017,1,1,0,0,0,0,0,0
DP Nannes ,Australia,2009,2009,1,1,0,0,0,0,0,0
Naseer Malik ,Pakistan,1975,1975,3,3,0,0,0,0,0,0
Nasim-ul-Ghani ,Pakistan,1973,1973,1,1,0,0,0,0,0,0
Nasir Aziz ,United Arab Emirates,2014,2015,5,5,0,0,0,0,0,0
Nasir Hameed ,Hong Kong,2004,2004,1,1,0,0,0,0,0,0
Nasir Javed ,United States of America,2004,2004,1,1,0,0,0,0,0,0
T Natarajan ,India,2020,2021,2,2,0,0,0,0,0,0
Naumanullah ,Pakistan,2008,2008,1,1,0,0,0,0,0,0
Naved Anjum ,Pakistan,1984,1992,13,13,0,0,0,0,0,0
Naveed Zadran ,Afghanistan,2024,2024,2,2,0,0,0,0,0,0
MN Nawaz ,Sri Lanka,1998,2002,3,3,0,0,0,0,0,0
AM Nayar ,India,2009,2009,3,3,0,0,0,0,0,0
LR Naylor ,Scotland,2023,2023,1,1,0,0,0,0,0,0
N Ncube ,Zimbabwe,2011,2011,1,1,0,0,0,0,0,0
A Ndlovu ,Zimbabwe,2019,2019,2,2,0,0,0,0,0,0
SO Ngoche ,Kenya,2010,2014,14,14,0,0,0,0,0,0
IA Nicolson ,Zimbabwe,2010,2010,2,2,0,0,0,0,0,0
RG Nijman ,NED,2009,2009,1,1,0,0,0,0,0,0
AA Noffke ,Australia,2008,2008,1,1,0,0,0,0,0,0
Nurul Abedin ,BAN,1986,1990,4,4,0,0,0,0,0,0
W O'Rourke ,New Zealand,2023,2023,3,3,0,0,0,0,0,0
KJ O'Keeffe ,Australia,1977,1977,2,2,0,0,0,0,0,0
D Olivier ,South Africa,2019,2019,2,2,0,0,0,0,0,0
Omid Shafi Rahman ,United Arab Emirates,2024,2024,2,2,0,0,0,0,0,0
DR O'Sullivan ,New Zealand,1974,1976,3,3,0,0,0,0,0,0
J Overton ,England,2024,2024,2,2,0,0,0,0,0,0
MB Owens ,New Zealand,1992,1992,1,1,0,0,0,0,0,0
M Panchal ,NED,2007,2007,1,1,0,0,0,0,0,0
GK Pandey ,India,1999,1999,2,2,0,0,0,0,0,0
R Parag ,India,2024,2024,1,1,0,0,0,0,0,0
D Parashar ,United Arab Emirates,2024,2024,4,4,0,0,0,0,0,0
BA Parchment ,West Indies,2007,2008,7,7,0,0,0,0,0,0
SD Parry ,England,2014,2014,2,2,0,0,0,0,0,0
Parvez Rasool ,India,2014,2014,1,1,0,0,0,0,0,0
NT Pascal ,West Indies,2009,2009,1,1,0,0,0,0,0,0
SP Pasqual ,Sri Lanka,1979,1979,2,2,0,0,0,0,0,0
A Patel ,Canada,2003,2003,2,2,0,0,0,0,0,0
JM Patel ,Canada,1979,1979,3,3,0,0,0,0,0,0
KA Patel ,Kenya,2006,2006,2,2,0,0,0,0,0,0
ML Patel ,Kenya,2004,2006,3,3,0,0,0,0,0,0
RGM Patel ,India,1988,1988,1,1,0,0,0,0,0,0
R Pathan ,Canada,2013,2013,1,1,0,0,0,0,0,0
RM Patidar ,India,2023,2023,1,1,0,0,0,0,0,0
BMW Patterson ,Scotland,1999,1999,3,3,0,0,0,0,0,0
DA Payne ,England,2022,2022,1,1,0,0,0,0,0,0
GE Peckover ,Zimbabwe,1983,1983,3,3,0,0,0,0,0,0
CW Perchard ,JER,2023,2023,5,5,0,0,0,0,0,0
KG Perera ,Sri Lanka,1986,1986,1,1,0,0,0,0,0,0
N Peter ,South Africa,2024,2024,2,2,0,0,0,0,0,0
N Phillip ,West Indies,1978,1978,1,1,0,0,0,0,0,0
HSM Pieris ,Sri Lanka,1975,1975,3,3,0,0,0,0,0,0
K Pierre ,West Indies,2019,2020,3,3,0,0,0,0,0,0
ADJ Pitcher ,BER,2007,2007,3,3,0,0,0,0,0,0
PI Pocock ,England,1985,1985,1,1,0,0,0,0,0,0
DJ Pringle ,East (and Central) Africa,1975,1975,2,2,0,0,0,0,0,0
TJG Pringle ,NED,2022,2022,4,4,0,0,0,0,0,0
CA Pujara ,India,2013,2014,5,4,0,0,0,0,0,0
Y Punja ,United Arab Emirates,2015,2015,1,1,0,0,0,0,0,0
M Pushpakumara ,Sri Lanka,2009,2010,3,2,0,0,0,0,0,0
Qais Ahmad ,Afghanistan,2022,2024,3,3,0,0,0,0,0,0
CT Radley ,England,1978,1978,4,4,0,0,0,0,0,0
Rafiqul Alam ,BAN,1986,1986,2,2,0,0,0,0,0,0
Rafiqul Islam ,BAN,2002,2002,1,1,0,0,0,0,0,0
PBB Rajapaksa ,Sri Lanka,2021,2021,5,5,0,0,0,0,0,0
RR Ramdass ,West Indies,2005,2005,1,1,0,0,0,0,0,0
D Ramnarine ,West Indies,1997,2001,4,4,0,0,0,0,0,0
DR Ramsammy ,Canada,2012,2012,1,1,0,0,0,0,0,0
Ramveer Rai ,United Arab Emirates,2004,2004,1,1,0,0,0,0,0,0
N Rana ,India,2021,2021,1,1,0,0,0,0,0,0
AN Ranasinghe ,Sri Lanka,1975,1982,9,9,0,0,0,0,0,0
N Ranatunga ,Sri Lanka,1993,1993,2,2,0,0,0,0,0,0
Randhir Singh ,India,1981,1983,2,2,0,0,0,0,0,0
Rashid Zia ,United States of America,2004,2004,2,2,0,0,0,0,0,0
NLK Ratnayake ,Sri Lanka,1989,1990,2,2,0,0,0,0,0,0
SS Raul ,India,1998,1998,2,2,0,0,0,0,0,0
Ravi Bishnoi ,India,2022,2022,1,1,0,0,0,0,0,0
Raza Hasan ,Pakistan,2014,2014,1,1,0,0,0,0,0,0
RE Redmond ,New Zealand,1973,1973,2,2,0,0,0,0,0,0
B Regmi ,NEP,2018,2019,4,4,0,0,0,0,0,0
CA Reid ,United States of America,2004,2004,2,2,0,0,0,0,0,0
RA Reifer ,West Indies,2019,2023,6,6,0,0,0,0,0,0
CEB Rice ,South Africa,1991,1991,3,3,0,0,0,0,0,0
EJ Richardson ,Ireland,2013,2013,2,2,0,0,0,0,0,0
EB Ringera ,Kenya,2011,2011,1,1,0,0,0,0,0,0
HP Rinke ,Zimbabwe,2006,2006,18,18,0,0,0,0,0,0
Rizwan Latif ,United Arab Emirates,2004,2004,1,1,0,0,0,0,0,0
SJ Roberts ,New Zealand,1990,1990,2,2,0,0,0,0,0,0
TB Robinson ,New Zealand,2024,2024,3,2,0,0,0,0,0,0
Robiul Islam ,BAN,2013,2013,3,3,0,0,0,0,0,0
TS Roland-Jones ,England,2017,2017,1,1,0,0,0,0,0,0
Saad Ali ,Pakistan,2019,2019,2,2,0,0,0,0,0,0
Saad Nasim ,Pakistan,2015,2015,3,3,0,0,0,0,0,0
Sagar Pun ,NEP,2018,2018,1,1,0,0,0,0,0,0
Saiful Islam ,BAN,1990,1997,7,7,0,0,0,0,0,0
Sajjad Ahmed ,BAN,1995,1995,2,2,0,0,0,0,0,0
Sajjad Akbar ,Pakistan,1990,1990,2,2,0,0,0,0,0,0
Saleem Pervez ,Pakistan,1980,1980,1,1,0,0,0,0,0,0
Saleem Raza ,United Arab Emirates,1994,1996,6,6,0,0,0,0,0,0
Salman Faris ,United Arab Emirates,2014,2014,3,3,0,0,0,0,0,0
Salman Farooq ,United Arab Emirates,2014,2014,1,1,0,0,0,0,0,0
Samiullah Khan ,Pakistan,2008,2008,2,2,0,0,0,0,0,0
Sami Aslam ,Pakistan,2015,2016,4,4,0,0,0,0,0,0
Sami Faridi ,Canada,2008,2008,3,3,0,0,0,0,0,0
GS Sandhu ,Australia,2015,2015,2,2,0,0,0,0,0,0
T Sangha ,Australia,2023,2023,2,2,0,0,0,0,0,0
Sayed Shirzad ,Afghanistan,2019,2019,2,1,0,0,0,0,0,0
RH Scholte ,NED,2002,2003,5,5,0,0,0,0,0,0
BN Schultz ,South Africa,1992,1992,1,1,0,0,0,0,0,0
GLS Scrimshaw ,England,2023,2023,1,1,0,0,0,0,0,0
GR Sealy ,Canada,1979,1979,3,3,0,0,0,0,0,0
TAP Sekhar ,India,1983,1985,4,4,0,0,0,0,0,0
KR Sen ,India,2022,2022,1,1,0,0,0,0,0,0
Shafiuddin Ahmed ,BAN,1997,2000,11,11,0,0,0,0,0,0
Shaheedur Rahman ,BAN,1986,1986,2,2,0,0,0,0,0,0
Shahid Anwar ,Pakistan,1996,1996,1,1,0,0,0,0,0,0
Shahnawaz Dahani ,Pakistan,2022,2022,2,2,0,0,0,0,0,0
Shehzad Altaf ,United Arab Emirates,1996,1996,2,2,0,0,0,0,0,0
Shahzad Khan ,Canada,2007,2007,1,1,0,0,0,0,0,0
Shahzaib Hasan ,Pakistan,2010,2010,3,3,0,0,0,0,0,0
Shakeel Ahmed jnr ,Pakistan,1995,1995,2,2,0,0,0,0,0,0
Shakeel Khan ,Pakistan,1987,1987,1,1,0,0,0,0,0,0
A Shamshudeen ,Canada,2007,2007,1,1,0,0,0,0,0,0
JNK Shannon ,Ireland,2013,2013,1,1,0,0,0,0,0,0
Shariful Haque ,BAN,1998,1998,1,1,0,0,0,0,0,0
PH Sharma ,India,1976,1976,2,2,0,0,0,0,0,0
AP Sheahan ,Australia,1972,1972,3,3,0,0,0,0,0,0
Sheikh Salahuddin ,BAN,1997,1997,6,6,0,0,0,0,0,0
V Shetty ,United Arab Emirates,2008,2014,2,2,0,0,0,0,0,0
M Shezi ,South Africa,2014,2014,1,1,0,0,0,0,0,0
M Shiraz ,Sri Lanka,2024,2024,2,2,0,0,0,0,0,0
S Shivnarine ,West Indies,1978,1978,1,1,0,0,0,0,0,0
Shuvagata Hom ,BAN,2011,2011,4,4,0,0,0,0,0,0
JD Siddons ,Australia,1988,1988,1,1,0,0,0,0,0,0
EHSN Silva ,United Arab Emirates,2008,2008,1,1,0,0,0,0,0,0
KJ Silva ,Sri Lanka,1995,1995,1,1,0,0,0,0,0,0
CEW Silverwood ,England,1996,2001,7,7,0,0,0,0,0,0
Simandeep Singh ,Hong Kong,2018,2018,1,1,0,0,0,0,0,0
RP Singh ,India,1986,1986,2,2,0,0,0,0,0,0
Skhawat Ali ,Hong Kong,2008,2014,4,4,0,0,0,0,0,0
WN Slack ,England,1986,1986,2,2,0,0,0,0,0,0
CL Smith ,England,1984,1984,4,4,0,0,0,0,0,0
DM Smith ,England,1986,1990,2,2,0,0,0,0,0,0
M Smith ,BER,2008,2008,1,1,0,0,0,0,0,0
MJ Smith ,Scotland,1999,1999,5,5,0,0,0,0,0,0
RAJ Smith ,Scotland,2016,2016,2,2,0,0,0,0,0,0
G Snyman ,Namibia,2003,2003,5,5,0,0,0,0,0,0
Sohail Butt ,United Arab Emirates,1994,1994,2,2,0,0,0,0,0,0
IS Sohi ,Canada,2024,2024,2,2,0,0,0,0,0,0
S Somasunder ,India,1996,1996,2,2,0,0,0,0,0,0
K Sonavale ,OMA,2024,2024,3,3,0,0,0,0,0,0
TE Srinivasan ,India,1980,1981,2,2,0,0,0,0,0,0
U Srivastava ,United States of America,2024,2024,2,2,0,0,0,0,0,0
RW Staple ,United States of America,2004,2004,2,2,0,0,0,0,0,0
NA Statham ,NED,2003,2009,3,3,0,0,0,0,0,0
MP Stead ,Canada,1979,1979,2,2,0,0,0,0,0,0
RD Steede ,BER,2006,2008,8,8,0,0,0,0,0,0
DS Steele ,England,1976,1976,1,1,0,0,0,0,0,0
BDH Stevens ,JER,2023,2023,1,1,0,0,0,0,0,0
SL Stewart ,New Zealand,2010,2010,4,4,0,0,0,0,0,0
PJR Steyn ,South Africa,1995,1995,1,1,0,0,0,0,0,0
Subashis Roy ,BAN,2016,2016,1,1,0,0,0,0,0,0
Sufyan Mehmood ,OMA,2021,2021,1,1,0,0,0,0,0,0
Sultan Ahmed ,United Arab Emirates,2019,2019,2,2,0,0,0,0,0,0
GP Sulzberger ,New Zealand,2000,2000,3,3,0,0,0,0,0,0
S Sumar ,East (and Central) Africa,1975,1975,1,1,0,0,0,0,0,0
Sunzamul Islam ,BAN,2017,2018,3,3,0,0,0,0,0,0
Surya Tamang ,NEP,2024,2024,2,2,0,0,0,0,0,0
SJ Swanepoel ,Namibia,2003,2003,5,5,0,0,0,0,0,0
MJ Swepson ,Australia,2022,2022,3,3,0,0,0,0,0,0
Khaled Ahmed ,BAN,2023,2023,2,2,0,0,0,0,0,0
Tabarak Dar ,Hong Kong,2004,2008,4,4,0,0,0,0,0,0
AR Tait ,New Zealand,1998,1999,5,5,0,0,0,0,0,0
Tanvir Mehdi ,Pakistan,1992,1992,1,1,0,0,0,0,0,0
Tariq Javed ,Canada,1979,1979,3,3,0,0,0,0,0,0
K Tathgur ,Canada,2024,2024,1,1,0,0,0,0,0,0
JP Taylor ,England,1993,1993,1,1,0,0,0,0,0,0
LB Taylor ,England,1986,1986,2,2,0,0,0,0,0,0
DJ Terbrugge ,South Africa,2000,2000,4,4,0,0,0,0,0,0
DJ ter Braak ,NED,2018,2018,2,2,0,0,0,0,0,0
VAB Tewarie ,NED,2011,2011,1,1,0,0,0,0,0,0
JG Thomas ,England,1986,1987,3,3,0,0,0,0,0,0
EP Thompson ,New Zealand,2009,2009,1,1,0,0,0,0,0,0
PIC Thompson ,West Indies,1997,1997,2,2,0,0,0,0,0,0
AL Thomson ,Australia,1971,1971,1,1,0,0,0,0,0,0
MH Tissera ,Sri Lanka,1975,1975,3,3,0,0,0,0,0,0
GC Tonge ,West Indies,2009,2009,5,5,0,0,0,0,0,0
PM Toohey ,Australia,1978,1979,5,4,0,0,0,0,0,0
GS Trimble ,Australia,1986,1986,2,2,0,0,0,0,0,0
MS Tshabalala ,South Africa,2007,2007,4,4,0,0,0,0,0,0
CK Tshuma ,Zimbabwe,2020,2020,2,2,0,0,0,0,0,0
CM Tuckett ,West Indies,1998,1998,1,1,0,0,0,0,0,0
JA Turner ,England,2024,2024,2,2,0,0,0,0,0,0
ML Udawatte ,Sri Lanka,2008,2008,9,9,0,0,0,0,0,0
Usman Mushtaq ,United Arab Emirates,2015,2015,1,1,0,0,0,0,0,0
Usman Rafiq ,United States of America,2023,2023,2,2,0,0,0,0,0,0
MG Vandort ,Sri Lanka,2006,2006,1,1,0,0,0,0,0,0
MWA van Nierop ,NED,2006,2006,2,2,0,0,0,0,0,0
KJJ van Noortwijk ,NED,1996,2003,9,9,0,0,0,0,0,0
BO van Rooi ,Namibia,2003,2003,3,3,0,0,0,0,0,0
RJ van Vuuren ,Namibia,2003,2003,5,5,0,0,0,0,0,0
CJPG van Zyl ,South Africa,1992,1992,2,2,0,0,0,0,0,0
JCB Vaughan ,Canada,1979,1979,3,3,0,0,0,0,0,0
M Venkataramana ,India,1988,1988,1,1,0,0,0,0,0,0
GE Vivian ,New Zealand,1973,1973,1,1,0,0,0,0,0,0
DM Vonhagt ,Sri Lanka,1985,1985,1,1,0,0,0,0,0,0
Wahidul Gani ,BAN,1988,1988,1,1,0,0,0,0,0,0
KP Walmsley ,New Zealand,2003,2003,2,2,0,0,0,0,0,0
R Walters ,Namibia,2003,2003,2,2,0,0,0,0,0,0
S Walusimbi ,East (and Central) Africa,1975,1975,3,3,0,0,0,0,0,0
Waqas Khan ,Hong Kong,2015,2017,8,8,0,0,0,0,0,0
Wasim Haider ,Pakistan,1992,1992,3,3,0,0,0,0,0,0
SL Watkin ,England,1994,1994,4,4,0,0,0,0,0,0
M Watkinson ,England,1996,1996,1,1,0,0,0,0,0,0
GD Watson ,Australia,1972,1972,2,2,0,0,0,0,0,0
RJ Webb ,New Zealand,1983,1983,3,3,0,0,0,0,0,0
AP Weerakkody ,Sri Lanka,1994,1994,1,1,0,0,0,0,0,0
S Weerakoon ,Sri Lanka,2012,2012,2,2,0,0,0,0,0,0
AP Wells ,England,1995,1995,1,1,0,0,0,0,0,0
CM Wells ,England,1985,1985,2,2,0,0,0,0,0,0
MD Wettimuny ,Sri Lanka,1983,1983,1,1,0,0,0,0,0,0
SRD Wettimuny ,Sri Lanka,1975,1979,3,3,0,0,0,0,0,0
K Whatham ,Canada,2011,2011,1,1,0,0,0,0,0,0
DF Whatmore ,Australia,1980,1980,1,1,0,0,0,0,0,0
RK Whelan ,Ireland,2007,2007,2,2,0,0,0,0,0,0
B White ,Ireland,2023,2023,2,2,0,0,0,0,0,0
RPAH Wickramaratne ,Sri Lanka,1993,1993,3,3,0,0,0,0,0,0
C Wickramasinghe ,Sri Lanka,2024,2024,1,1,0,0,0,0,0,0
KOK Williams ,West Indies,2017,2018,8,8,0,0,0,0,0,0
LB Williams ,South Africa,2021,2024,7,7,0,0,0,0,0,0
JG Williamson ,Scotland,1999,1999,2,2,0,0,0,0,0,0
CM Willoughby ,South Africa,2000,2003,3,3,0,0,0,0,0,0
L Wood ,England,2022,2023,2,1,0,0,0,0,0,0
AJ Woodcock ,Australia,1974,1974,1,1,0,0,0,0,0,0
LJ Woodcock ,New Zealand,2011,2011,4,4,0,0,0,0,0,0
T Yohannan ,India,2002,2002,3,3,0,0,0,0,0,0
Yunus Badat ,East (and Central) Africa,1975,1975,2,2,0,0,0,0,0,0
Zafar Gohar ,Pakistan,2015,2015,1,1,0,0,0,0,0,0
Zaheer Maqsood ,United Arab Emirates,2015,2015,2,2,0,0,0,0,0,0
Zahid Ahmed ,Pakistan,1987,1987,2,2,0,0,0,0,0,0
Zahid Mahmood ,Pakistan,2022,2022,4,4,0,0,0,0,0,0
Zahid Razzak ,BAN,1988,1990,3,3,0,0,0,0,0,0
Zahid Shah ,United Arab Emirates,2008,2008,2,2,0,0,0,0,0,0
MZ Zahir ,Canada,2009,2009,1,1,0,0,0,0,0,0
Zahir Khan ,Afghanistan,2019,2019,1,1,0,0,0,0,0,0
Zain Abbas ,Hong Kong,2008,2008,1,1,0,0,0,0,0,0
Zakir Hasan ,BAN,1997,1997,1,1,0,0,0,0,0,0
Zakir Hossain ,BAN,1998,1998,1,1,0,0,0,0,0,0
Zakir Khan ,Pakistan,1984,1990,17,16,0,0,0,0,0,0
Zakiullah Zaki ,Afghanistan,2012,2012,1,1,0,0,0,0,0,0
Zaman Khan ,Pakistan,2023,2023,1,1,0,0,0,0,0,0
Zeeshan Siddiqi ,Canada,2012,2014,2,2,0,0,0,0,0,0
Zia-ur-Rehman ,Afghanistan,2023,2023,1,1,0,0,0,0,0,0
Zubayr Hamza ,South Africa,2021,2021,1,1,0,0,0,0,0,0
Zuhaib Zubair ,United Arab Emirates,2024,2024,3,3,0,0,0,0,0,0
Zulfiqar Babar ,Pakistan,2014,2015,5,5,0,0,0,0,0,0
ZGF Foulkes ,New Zealand,2024,2024,1,NA,NA,NA,NA,NA,NA,NA
