Player,Country,Start,End,Matches,Innings,Dismissals,Caught,CaughtFielder,CaughtBehind,Stumped,MaxDismissalsInnings
Q de Kock ,South Africa,2012,2024,92,92,102,84,0,84,18,4
MS Dhoni ,India,2006,2019,98,97,91,57,0,57,34,5
IA Karim ,Kenya,2013,2024,64,62,89,64,2,62,25,5
JC Buttler ,England,2011,2024,129,128,87,74,7,67,13,3
DA Miller (SA/World),NA,2010,2024,129,129,83,82,81,1,1,4
AB de Villiers ,South Africa,2006,2017,78,78,72,65,44,21,7,4
Mushfiqur Rahim ,BAN,2006,2022,102,100,72,42,10,32,30,3
Mohammad Nabi ,Afghanistan,2010,2024,129,129,70,70,70,0,0,3
N Pooran ,West Indies,2016,2024,103,98,70,62,10,52,8,3
MJ Guptill ,New Zealand,2009,2022,122,121,68,68,68,0,0,3
GH Dockrell ,Ireland,2010,2024,141,138,65,65,65,0,0,3
SA Edwards ,NED,2018,2024,71,70,65,57,0,57,8,3
Mohammad Rizwan ,Pakistan,2015,2024,104,104,65,54,8,46,11,3
RG Sharma ,India,2007,2024,159,159,65,65,65,0,0,3
TG Southee ,New Zealand,2008,2024,126,124,65,65,65,0,0,2
MS Wade ,Australia,2011,2024,92,92,64,58,0,58,6,3
D Ndikubwimana ,RWN,2021,2024,73,72,63,52,3,49,11,4
D Ramdin ,West Indies,2006,2019,71,71,63,43,0,43,20,4
DA Warner ,Australia,2009,2024,110,110,62,62,62,0,0,3
Mohammad Shahzad ,Afghanistan,2010,2023,73,72,61,33,0,33,28,5
Kamran Akmal ,Pakistan,2006,2017,58,58,60,28,0,28,32,4
Litton Das ,BAN,2015,2024,92,91,60,52,29,23,8,3
MH Cross ,Scotland,2013,2024,76,73,59,43,0,43,16,4
LJ Tucker ,Ireland,2016,2024,74,74,59,54,10,44,5,3
ZE Green ,Namibia,2019,2024,61,60,54,47,0,47,7,4
V Kohli ,India,2010,2024,125,124,54,54,54,0,0,3
HH Pandya ,India,2016,2024,109,108,54,54,54,0,0,3
Babar Azam ,Pakistan,2016,2024,126,126,52,52,52,0,0,2
GJ Maxwell ,Australia,2012,2024,116,115,52,52,52,0,0,4
GD Phillips ,New Zealand,2017,2024,80,78,52,50,43,7,2,4
HT Tector ,Ireland,2019,2024,81,81,52,52,52,0,0,4
Umar Akmal ,Pakistan,2009,2019,84,84,52,50,39,11,2,3
Mahmudullah ,BAN,2007,2024,141,138,51,51,51,0,0,3
RR Pant ,India,2017,2024,76,74,51,40,2,38,11,3
Fakhar Zaman ,Pakistan,2017,2024,92,92,50,50,50,0,0,3
AJ Finch ,Australia,2011,2022,103,102,50,50,50,0,0,3
RR Patel ,Kenya,2008,2024,82,82,50,50,50,0,0,3
Shoaib Malik (ICC/PAK),NA,2006,2021,124,124,50,50,50,0,0,3
Nizakat Khan ,Hong Kong,2014,2024,99,98,49,49,49,0,0,3
CJ Jordan ,England,2014,2024,95,94,48,48,48,0,0,3
Muhammad Waseem ,United Arab Emirates,2021,2024,61,61,48,48,48,0,0,3
JM Bairstow ,England,2011,2024,80,79,47,46,34,12,1,2
GC Wilson ,Ireland,2008,2020,81,79,47,40,11,29,7,4
EJG Morgan ,England,2009,2022,115,114,46,46,46,0,0,3
S Muniandy ,MAS,2019,2024,85,83,46,46,46,0,0,3
Sarfaraz Ahmed ,Pakistan,2010,2021,61,61,46,36,0,36,10,3
Soumya Sarkar ,BAN,2015,2024,85,84,46,46,46,0,0,3
LRPL Taylor ,New Zealand,2006,2020,102,102,46,46,46,0,0,3
SA Yadav ,India,2021,2024,78,78,46,46,46,0,0,3
Babar Hayat ,Hong Kong,2014,2024,79,78,45,45,45,0,0,4
KC Sangakkara ,Sri Lanka,2006,2014,56,56,45,25,0,25,20,3
KS Williamson ,New Zealand,2011,2024,93,92,45,45,45,0,0,3
DJ Bravo ,West Indies,2006,2021,91,88,44,44,44,0,0,3
BB McCullum ,New Zealand,2005,2015,71,71,44,36,12,24,8,3
Najibullah Zadran ,Afghanistan,2012,2024,107,107,44,44,44,0,0,2
LD Chandimal ,Sri Lanka,2010,2022,68,68,43,37,19,18,6,4
R Powell ,West Indies,2017,2024,88,86,43,43,43,0,0,2
TL Seifert ,New Zealand,2018,2024,61,59,43,35,3,32,8,3
KA Pollard ,West Indies,2008,2022,101,97,42,42,42,0,0,2
SK Raina ,India,2006,2018,78,78,42,42,42,0,0,3
MJ Santner ,New Zealand,2015,2024,106,104,42,42,42,0,0,3
Sikandar Raza ,Zimbabwe,2013,2024,96,96,42,42,42,0,0,3
Virandeep Singh ,MAS,2019,2024,84,83,42,38,34,4,4,2
RP Burl ,Zimbabwe,2018,2024,82,82,41,41,41,0,0,3
BKG Mendis ,Sri Lanka,2016,2024,75,75,41,30,8,22,11,3
L Siaka ,Papau New Guinea,2015,2024,62,62,41,41,41,0,0,4
SPD Smith ,Australia,2010,2024,67,67,41,41,41,0,0,3
Aasif Sheikh ,NEP,2021,2024,54,54,40,28,4,24,12,3
Ahmad Ramdoni ,INA,2022,2024,47,47,40,31,0,31,9,3
A Balbirnie ,Ireland,2015,2024,110,108,40,40,40,0,0,2
JW Jenner ,JER,2019,2024,50,50,40,40,40,0,0,4
KJ O'Brien ,Ireland,2008,2021,110,106,40,40,40,0,0,2
PR Stirling ,Ireland,2009,2024,147,146,40,40,40,0,0,3
Usman Patel ,KUW,2020,2024,50,50,40,26,0,26,14,4
AD Hales ,England,2011,2022,75,74,39,39,39,0,0,2
CN Kakuru ,UGA,2022,2024,40,39,39,21,0,21,18,4
Rahmanullah Gurbaz ,Afghanistan,2019,2024,63,63,39,35,2,33,4,2
MD Shanaka ,Sri Lanka,2015,2024,102,101,39,39,39,0,0,3
MR Adair ,Ireland,2019,2024,88,88,38,38,38,0,0,2
DP Conway ,New Zealand,2020,2024,50,50,38,32,7,25,6,3
KD Karthik (ICC/IND),NA,2006,2022,60,58,38,30,11,19,8,4
CS MacLeod ,Scotland,2009,2022,64,64,38,38,38,0,0,4
IS Sodhi ,New Zealand,2014,2024,119,115,38,38,38,0,0,2
H Klaasen ,South Africa,2018,2024,56,56,37,33,17,16,4,2
AK Markram ,South Africa,2019,2024,57,57,37,37,37,0,0,4
CO Obuya ,Kenya,2007,2024,75,74,37,37,37,0,0,3
MG Erasmus ,Namibia,2019,2024,65,65,36,36,36,0,0,4
JDS Neesham ,New Zealand,2012,2024,79,77,36,36,36,0,0,2
Rashid Khan (AFG/ICC),NA,2015,2024,93,93,36,36,36,0,0,2
Shadab Khan ,Pakistan,2017,2024,104,104,36,36,36,0,0,3
Syed Aziz ,MAS,2019,2024,90,88,36,29,25,4,7,4
DS Airee ,NEP,2018,2024,74,74,35,35,35,0,0,2
BN Cooper ,NED,2013,2021,58,57,35,35,35,0,0,3
JP Duminy ,South Africa,2007,2019,81,81,35,35,35,0,0,2
S Nadigotla ,ROM,2019,2024,35,35,35,30,1,29,5,3
LMP Simmons ,West Indies,2007,2021,68,67,35,35,34,1,0,3
S Chandramohan ,SGP,2019,2024,47,47,34,34,34,0,0,3
K Doriga ,Papau New Guinea,2019,2024,42,42,34,29,0,29,5,5
PW Hasaranga ,Sri Lanka,2019,2024,76,75,34,34,34,0,0,2
DJ Mitchell ,New Zealand,2019,2024,67,65,34,34,34,0,0,3
TH David (AUS/SGP),NA,2019,2024,54,54,33,33,33,0,0,4
TM Dilshan ,Sri Lanka,2006,2016,80,80,33,31,26,5,2,2
SO Ngoche ,Kenya,2010,2024,98,96,33,33,33,0,0,3
MD Patel ,United States of America,2019,2024,34,34,33,21,8,13,12,3
AP Rajeevan ,TAN,2022,2024,50,48,33,27,4,23,6,2
K Waiswa ,UGA,2020,2024,73,72,33,33,33,0,0,2
AC Agar ,Australia,2016,2024,49,49,32,32,32,0,0,3
Awais Ahmed ,ESP,2019,2023,28,27,32,21,0,21,11,4
C Campher ,Ireland,2021,2024,58,58,32,32,32,0,0,2
RR Hendricks ,South Africa,2014,2024,76,76,32,32,32,0,0,2
AU Rashid ,England,2009,2024,119,118,32,32,32,0,0,2
Sachin Mandy ,GER,2022,2024,23,23,32,21,3,18,11,4
PM Seelaar ,NED,2008,2021,77,75,32,32,32,0,0,2
S Singh ,Kenya,2021,2024,42,42,32,24,8,16,8,3
V Aravind ,United Arab Emirates,2020,2024,48,48,31,26,5,21,5,4
K Bhurtel ,NEP,2021,2024,53,53,31,31,31,0,0,4
JSE Dunford ,JER,2019,2024,36,36,31,17,0,17,14,4
CR Ervine ,Zimbabwe,2010,2024,71,71,31,31,31,0,0,3
MR Marsh ,Australia,2011,2024,65,65,31,31,31,0,0,2
B Masaba ,UGA,2019,2024,63,61,31,31,31,0,0,2
RK Paudel ,NEP,2019,2024,59,59,31,31,31,0,0,3
DJG Sammy (WI/World),NA,2007,2017,68,68,31,31,31,0,0,4
Shakib Al Hasan ,BAN,2006,2024,129,127,31,31,31,0,0,2
Gulbadin Naib ,Afghanistan,2012,2024,73,72,30,30,30,0,0,2
V Mbazo ,BOT,2019,2024,35,34,30,14,0,14,16,4
Mohamed Azzam ,MDV,2019,2024,43,43,30,23,1,22,7,3
Mohammad Hafeez ,Pakistan,2006,2021,119,119,30,30,30,0,0,2
Najmul Hossain Shanto ,BAN,2019,2024,49,49,30,30,30,0,0,3
Nurul Hasan ,BAN,2016,2022,46,45,30,21,0,21,9,3
NLTC Perera (ICC/SL/World),NA,2010,2021,84,84,30,30,30,0,0,2
L Ronchi (AUS/ICC/NZ),NA,2008,2018,33,33,30,24,0,24,6,3
Shahid Afridi (ICC/PAK),NA,2006,2018,99,99,30,30,30,0,0,3
A Vala ,Papau New Guinea,2015,2024,63,63,30,30,30,0,0,3
W Barresi ,NED,2012,2024,46,44,29,28,2,26,1,4
Basil Hameed ,United Arab Emirates,2020,2024,61,61,29,29,29,0,0,2
RW Chakabva ,Zimbabwe,2008,2022,49,49,29,27,4,23,2,3
MA Leask ,Scotland,2013,2024,67,64,29,29,29,0,0,3
RN Patel ,Kenya,2019,2024,56,54,29,29,29,0,0,2
SI Runsewe ,NGA,2019,2024,41,40,29,27,8,19,2,3
C Sudarsanan ,MLT,2023,2024,21,21,29,27,0,27,2,3
JK Theodore ,GHA,2021,2024,38,38,29,22,0,22,7,3
SC Williams ,Zimbabwe,2006,2024,81,81,29,29,29,0,0,2
M Akayezu ,RWN,2021,2024,80,79,28,28,28,0,0,2
J Bangura ,Sri LankaE,2021,2024,34,34,28,21,0,21,7,3
PW Borren ,NED,2008,2017,43,41,28,28,28,0,0,4
AT Carey ,Australia,2018,2021,38,37,28,19,5,14,9,3
RA Jadeja ,India,2009,2024,74,74,28,28,28,0,0,3
WP Masakadza ,Zimbabwe,2015,2024,55,55,28,28,28,0,0,4
Mohammed Rizlan ,QAT,2019,2024,36,36,28,18,3,15,10,3
HG Munsey ,Scotland,2015,2024,74,71,28,28,28,0,0,3
R Mutumbami ,Zimbabwe,2015,2022,29,29,28,23,5,18,5,4
SV Samson ,India,2015,2024,37,37,28,23,10,13,5,2
Zubaidi Zulkifle ,MAS,2019,2024,60,59,28,28,28,0,0,3
Abrar Bilal ,Aut,2019,2024,19,19,27,18,0,18,9,4
Ainool Hafizs ,MAS,2019,2024,46,46,27,16,3,13,11,3
HC Brook ,England,2022,2024,39,39,27,27,27,0,0,2
SO Hetmyer ,West Indies,2018,2024,62,58,27,27,27,0,0,3
JO Holder ,West Indies,2014,2024,63,60,27,27,27,0,0,2
AD Mathews ,Sri Lanka,2009,2024,90,90,27,27,27,0,0,2
NJ O'Brien ,Ireland,2008,2016,30,28,27,17,2,15,10,4
MP O'Dowd ,NED,2015,2024,77,76,27,27,27,0,0,2
JJ Smit ,Namibia,2019,2024,55,54,27,27,27,0,0,3
O Tuyisenge ,RWN,2021,2024,77,76,27,27,27,0,0,3
F Achelam ,UGA,2019,2024,39,38,26,21,1,20,5,4
MS Chapman (HKG/NZ),NA,2014,2024,78,75,26,26,26,0,0,2
IDA Damarell ,GUE,2020,2024,27,27,26,16,0,16,10,3
GJ Delany ,Ireland,2019,2024,75,75,26,26,26,0,0,2
ADS Fletcher ,West Indies,2008,2024,58,55,26,24,12,12,2,3
JN Frylinck ,Namibia,2019,2024,65,64,26,26,26,0,0,3
Haider Butt ,BHR,2021,2024,55,54,26,26,26,0,0,2
Iftikhar Ahmed ,Pakistan,2016,2024,66,66,26,26,26,0,0,3
Janak Prakash ,SGP,2019,2024,43,43,26,26,26,0,0,3
NL McCullum ,New Zealand,2007,2016,63,63,26,26,26,0,0,3
Manpreet Singh ,SGP,2019,2024,40,40,26,20,2,18,6,2
Mohammad Nawaz (3) ,Pakistan,2016,2024,60,60,26,26,26,0,0,3
RG Mukasa ,UGA,2019,2024,58,57,26,26,26,0,0,2
C Munoz-Mills ,ESP,2019,2024,41,40,26,26,26,0,0,3
K Nassoro ,TAN,2021,2024,65,63,26,26,26,0,0,2
Zeeshan Ali ,Hong Kong,2022,2024,44,43,26,19,1,18,7,4
FA Allen ,West Indies,2018,2024,39,38,25,25,25,0,0,2
JJ Atkinson ,Hong Kong,2014,2024,29,29,25,24,6,18,1,3
Meet Bhavsar ,KUW,2019,2024,59,59,25,23,15,8,2,3
D Doyle-Calle ,ESP,2022,2024,30,29,25,25,25,0,0,2
Karan KC ,NEP,2015,2024,75,75,25,25,25,0,0,2
AM Kimote ,TAN,2021,2024,67,65,25,25,25,0,0,3
MO Kitunda ,TAN,2021,2024,55,54,25,16,8,8,9,3
LS Livingstone ,England,2017,2024,55,55,25,25,25,0,0,3
W Madhevere ,Zimbabwe,2020,2024,69,69,25,25,25,0,0,2
H Masakadza ,Zimbabwe,2006,2019,66,66,25,25,25,0,0,3
MJ Richardson ,GER,2019,2023,25,25,25,15,0,15,10,4
Rohan Mustafa ,United Arab Emirates,2014,2023,58,58,25,25,25,0,0,2
Sabbir Rahman ,BAN,2014,2022,48,47,25,25,25,0,0,3
PD Salt ,England,2022,2024,38,38,25,23,16,7,2,2
Sompal Kami ,NEP,2014,2024,74,74,25,25,25,0,0,2
TP Ura ,Papau New Guinea,2015,2024,60,60,25,25,25,0,0,2
Ahmed Faiz ,MAS,2019,2024,81,79,24,24,24,0,0,2
Ayaan Khan ,OMA,2021,2024,42,42,24,24,24,0,0,4
TS Bharaj ,DEN,2019,2024,32,30,24,21,7,14,3,5
F du Plessis (SA/World),NA,2012,2020,50,50,24,24,24,0,0,2
V Ganesan ,GER,2019,2024,47,47,24,24,24,0,0,3
DJ Hussey ,Australia,2008,2012,39,39,24,24,24,0,0,2
BA King ,West Indies,2019,2024,60,59,24,24,24,0,0,2
Naseem Khushi ,OMA,2017,2024,51,51,24,19,4,15,5,2
AR Patel ,India,2015,2024,66,65,24,24,24,0,0,2
MDKJ Perera ,Sri Lanka,2013,2024,74,73,24,18,8,10,6,3
KL Rahul ,India,2016,2022,72,71,24,23,19,4,1,2
V Saini ,ROM,2020,2024,40,40,24,24,24,0,0,2
PA van Meekeren ,NED,2013,2024,71,69,24,24,24,0,0,2
J Charles ,West Indies,2011,2024,57,57,23,21,19,2,2,2
BJ Haddin ,Australia,2006,2014,34,34,23,17,0,17,6,3
Ibrahim Rizan ,MDV,2019,2024,42,42,23,23,23,0,0,3
G Malla ,NEP,2014,2022,45,45,23,23,23,0,0,3
SS McKechnie ,Hong Kong,2019,2023,30,30,23,14,0,14,9,3
Muhammad Amir ,MAS,2019,2024,50,50,23,23,23,0,0,2
Mustafizur Rahman ,BAN,2015,2024,106,105,23,23,23,0,0,3
MP Stoinis ,Australia,2015,2024,74,73,23,23,23,0,0,2
SR Thompson ,Ireland,2014,2019,41,39,23,23,23,0,0,3
RE van der Merwe (NED/SA),NA,2009,2024,60,59,23,23,23,0,0,2
S Veerapathiran ,BHR,2020,2024,43,43,23,23,23,0,0,4
CL White ,Australia,2007,2014,47,47,23,23,23,0,0,2
MM Ali ,England,2014,2024,92,91,22,22,22,0,0,2
F Banunaek ,INA,2022,2024,44,44,22,22,22,0,0,3
TA Boult ,New Zealand,2013,2024,61,61,22,22,22,0,0,3
E Chigumbura ,Zimbabwe,2006,2020,57,57,22,22,22,0,0,2
KJ Coetzer ,Scotland,2008,2021,70,68,22,22,22,0,0,2
SM Curran ,England,2019,2024,58,58,22,22,22,0,0,2
L Emilio ,MOZ,2019,2022,24,23,22,13,2,11,9,4
Hamza Tariq ,Canada,2013,2022,26,26,22,16,2,14,6,3
Imad Wasim ,Pakistan,2015,2024,75,75,22,22,22,0,0,2
HA Jackson ,Fran,2021,2024,23,23,22,18,0,18,4,4
S Lamichhane (ICC/NEP),NA,2018,2024,58,58,22,22,22,0,0,2
DJ Malan ,England,2017,2023,62,61,22,22,22,0,0,2
J Mees ,LUX,2019,2024,40,40,22,20,5,15,2,2
WTS Porterfield ,Ireland,2008,2018,61,59,22,22,22,0,0,2
KH Prajapati ,OMA,2021,2024,47,47,22,22,22,0,0,2
DMW Rawlins ,BER,2019,2023,28,28,22,22,22,0,0,3
Riazat Ali Shah ,UGA,2019,2024,63,62,22,22,22,0,0,2
MA Starc ,Australia,2012,2024,65,65,22,22,22,0,0,2
BA Stokes ,England,2011,2022,43,42,22,22,22,0,0,3
BRM Taylor ,Zimbabwe,2006,2021,45,45,22,20,3,17,2,3
Aizaz Khan ,Hong Kong,2014,2024,85,84,21,21,21,0,0,2
CJ Anderson (NZ/USA),NA,2012,2024,42,42,21,21,21,0,0,4
Anshuman Rath ,Hong Kong,2015,2024,52,51,21,21,21,0,0,3
Asif Ali ,Pakistan,2018,2023,58,58,21,21,21,0,0,2
S Bau ,Papau New Guinea,2016,2024,56,56,21,21,21,0,0,3
B Bhandari ,NEP,2014,2024,40,40,21,13,3,10,8,3
SCJ Broad ,England,2006,2014,56,56,21,21,21,0,0,3
C Chete ,MWest Indies,2019,2024,26,26,21,17,0,17,4,3
DM de Silva ,Sri Lanka,2015,2024,45,44,21,21,21,0,0,2
Ehsan Khan ,Hong Kong,2016,2024,78,77,21,21,21,0,0,2
MD Gunathilaka ,Sri Lanka,2016,2022,46,45,21,21,21,0,0,3
JP Kotze ,Namibia,2019,2024,44,43,21,17,10,7,4,3
SL Malinga ,Sri Lanka,2006,2020,84,83,21,21,21,0,0,2
A Shirai-Patmore ,Japan,2022,2024,26,26,21,11,0,11,10,3
K Rabada ,South Africa,2014,2024,65,65,21,21,21,0,0,3
Ali Raza ,Belg,2021,2024,20,20,21,18,2,16,3,3
AD Russell ,West Indies,2011,2024,83,80,21,21,21,0,0,2
Sami Sohail ,MWest Indies,2019,2024,46,46,21,21,21,0,0,3
N Vanua ,Papau New Guinea,2015,2024,58,58,21,21,21,0,0,2
Abhishek Ahuja ,HUN,2022,2024,17,16,20,17,0,17,3,3
Aaftab Alam Khan ,MLT,2021,2023,27,27,20,18,3,15,2,2
Ahmed Raza ,United Arab Emirates,2014,2022,55,55,20,20,20,0,0,2
Asghar Afghan ,Afghanistan,2010,2021,75,75,20,20,20,0,0,2
PS Athavale ,OMA,2023,2024,21,21,20,13,0,13,7,3
MTMMJ Ave ,COK,2022,2024,12,12,20,18,9,9,2,5
RD Berrington ,Scotland,2008,2024,97,94,20,20,20,0,0,2
SR Bhudia ,Kenya,2019,2024,44,43,20,20,20,0,0,2
Bilal Tahir ,KUW,2019,2024,46,46,20,20,20,0,0,4
Z Bimenyimana ,RWN,2021,2024,78,77,20,20,20,0,0,2
W Boshoff ,SWE,2021,2023,20,20,20,13,1,12,7,3
L Bruce ,GIBR,2021,2024,42,42,20,20,20,0,0,3
C de Grandhomme ,New Zealand,2012,2021,41,41,20,20,20,0,0,4
BFW de Leede ,NED,2018,2024,41,41,20,20,20,0,0,3
CH Gayle ,West Indies,2006,2021,79,76,20,20,20,0,0,2
Haris Rauf ,Pakistan,2020,2024,75,75,20,20,20,0,0,2
MEK Hussey ,Australia,2005,2012,38,38,20,20,20,0,0,3
D Kansonkho ,MWest Indies,2019,2024,46,46,20,20,20,0,0,2
C Kieswetter ,England,2010,2012,25,25,20,17,0,17,3,3
ND Laegsgaard ,DEN,2019,2024,29,27,20,20,20,0,0,3
A Limdawala ,MWest Indies,2022,2024,33,33,20,20,20,0,0,3
O Manishimwe ,RWN,2022,2024,65,65,20,20,11,9,0,2
Manpreet Singh ,ITA,2019,2023,20,19,20,13,0,13,7,4
PK Matautaava ,VAN,2019,2024,28,28,20,20,20,0,0,3
K Motlhanka ,BOT,2019,2024,40,39,20,16,13,3,4,4
YI Patel ,KUW,2022,2024,41,41,20,20,20,0,0,2
Rafiullah ,OMA,2022,2024,32,32,20,20,20,0,0,3
Ravinderpal Singh ,Canada,2019,2024,35,34,20,20,20,0,0,3
A Shreshta ,NGA,2021,2023,22,22,20,18,0,18,2,3
M Simpson-Parker ,Aut,2019,2024,37,37,20,19,16,3,1,3
RK Singh ,India,2023,2024,30,30,20,20,20,0,0,3
S Vashisht ,ROM,2019,2024,34,34,20,20,20,0,0,2
SR Watson ,Australia,2006,2016,58,58,20,20,20,0,0,2
D Wiese (NAM/SA),NA,2013,2024,54,54,20,20,20,0,0,2
Afif Hossain ,BAN,2018,2023,69,68,19,19,19,0,0,2
FH Allen ,New Zealand,2021,2024,47,46,19,19,19,0,0,2
Aman Desai ,SGP,2022,2024,27,27,19,17,1,16,2,2
HM Amla (SA/World),NA,2009,2018,44,44,19,19,19,0,0,2
Aqib Ilyas ,OMA,2015,2024,56,56,19,19,19,0,0,2
IKEG Artawan ,INA,2022,2024,48,48,19,19,19,0,0,4
SW Billings (ENG/ICC),NA,2015,2022,37,36,19,17,13,4,2,3
MV Boucher ,South Africa,2005,2010,25,25,19,18,0,18,1,3
CR Brathwaite ,West Indies,2011,2019,41,41,19,19,19,0,0,2
FA Cossa ,MOZ,2019,2024,37,36,19,19,19,0,0,3
SS Cottrell ,West Indies,2014,2023,45,44,19,19,19,0,0,2
S Dhawan ,India,2011,2021,68,67,19,19,19,0,0,2
LB Ferbrache ,GUE,2019,2024,31,31,19,19,19,0,0,2
TWM Latham ,New Zealand,2012,2023,26,25,19,15,2,13,4,3
I Liyanage ,QAT,2020,2024,35,35,19,16,3,13,3,2
C Munro ,New Zealand,2012,2020,65,64,19,19,19,0,0,2
CW Perchard ,JER,2019,2024,47,47,19,19,19,0,0,2
JJ Roy ,England,2014,2022,64,64,19,19,19,0,0,2
C Rubagumya ,RWN,2021,2024,75,74,19,19,19,0,0,2
Saad Bin Zafar ,Canada,2019,2024,49,48,19,19,19,0,0,3
Samiullah Shinwari ,Afghanistan,2010,2022,65,65,19,19,19,0,0,1
E Sebareme ,RWN,2021,2024,65,64,19,19,19,0,0,2
S Ssesazi ,UGA,2021,2024,82,81,19,19,14,5,0,2
T Stubbs ,South Africa,2022,2024,35,35,19,19,19,0,0,2
S Thakor ,TAN,2021,2024,58,56,19,19,19,0,0,3
CJA Amini ,Papau New Guinea,2015,2024,59,59,18,18,18,0,0,2
DG Blampied ,JER,2019,2024,42,42,18,18,18,0,0,2
Hisham Shaikh ,KSA,2021,2024,34,34,18,18,18,0,0,2
Jatinder Singh ,OMA,2015,2024,56,56,18,18,18,0,0,2
C Madande ,Zimbabwe,2022,2024,33,33,18,17,1,16,1,2
W Miyauchi ,Japan,2023,2024,23,23,18,12,3,9,6,3
Mohammad Nadeem ,OMA,2015,2024,54,54,18,18,18,0,0,3
Mohammad Naim ,BAN,2019,2022,35,35,18,18,18,0,0,2
AR Ramjani ,UGA,2022,2024,45,45,18,18,18,0,0,2
JE Root ,England,2012,2019,32,32,18,18,18,0,0,2
Shiraz Khan ,KUW,2019,2024,53,53,18,18,18,0,0,2
M Shumba ,Zimbabwe,2020,2022,30,30,18,18,18,0,0,2
P Silas ,BOT,2019,2023,29,28,18,18,18,0,0,3
GC Smith ,South Africa,2005,2011,33,33,18,18,18,0,0,2
BDH Stevens ,JER,2019,2022,20,20,18,18,18,0,0,3
Tamim Iqbal (BAN/ICC/World),NA,2007,2020,78,76,18,18,18,0,0,2
Umar Gul ,Pakistan,2007,2016,60,60,18,18,18,0,0,2
Umer Toor ,BHR,2022,2024,31,31,18,14,9,5,4,3
HE van der Dussen ,South Africa,2018,2024,48,48,18,18,18,0,0,2
Washington Sundar ,India,2017,2024,52,51,18,18,18,0,0,2
Abdul Waheed ,KSA,2020,2024,40,40,17,17,17,0,0,3
Abdul Hashmi ,DEN,2019,2024,23,21,17,11,0,11,6,3
S Adedeji ,NGA,2019,2024,43,42,17,17,17,0,0,3
TC Barker ,LUX,2019,2024,40,40,17,17,17,0,0,2
J Botha ,South Africa,2006,2012,40,40,17,17,17,0,0,2
C Chatphaisan ,THA,2022,2024,35,35,17,17,17,0,0,2
N Davin ,Namibia,2019,2024,34,34,17,17,17,0,0,3
AC Gilchrist ,Australia,2005,2008,13,13,17,17,0,17,0,4
Ibrahim Hassan ,MDV,2019,2024,48,48,17,17,17,0,0,3
Ibrahim Zadran ,Afghanistan,2019,2024,44,44,17,17,17,0,0,2
DPMD Jayawardene ,Sri Lanka,2006,2014,55,55,17,17,17,0,0,2
CK Kapugedera ,Sri Lanka,2006,2017,43,43,17,17,17,0,0,3
FJ Klaassen ,NED,2018,2024,39,38,17,17,17,0,0,2
KMDN Kulasekara ,Sri Lanka,2008,2017,58,58,17,17,17,0,0,2
H Lakov ,BUL,2019,2022,35,34,17,17,17,0,0,3
JB Little ,Ireland,2016,2024,69,69,17,17,17,0,0,2
Mohammad Wasim (1) ,Pakistan,2021,2024,29,29,17,17,17,0,0,2
AK Mohan ,FIN,2019,2023,25,25,17,15,6,9,2,3
JA Morkel ,South Africa,2005,2015,50,50,17,17,17,0,0,2
Muhammad Tanveer ,QAT,2019,2024,53,53,17,17,17,0,0,2
TW Nightingale ,GUE,2020,2024,30,30,17,17,17,0,0,2
S Ravichandran ,Japan,2022,2024,34,34,17,17,17,0,0,2
E Rukiriza ,RWN,2023,2024,44,44,17,17,17,0,0,2
Saber Zakhil ,Belg,2019,2024,43,43,17,17,17,0,0,2
Scott Austin ,CYP,2021,2024,19,19,17,17,17,0,0,4
II Selemani ,TAN,2021,2024,63,61,17,17,17,0,0,2
HAM Shah ,DEN,2019,2024,32,30,17,17,17,0,0,3
Shaheen Shah Afridi ,Pakistan,2018,2024,73,73,17,17,17,0,0,3
Shaheryar Butt ,Belg,2019,2024,38,38,17,17,12,5,0,2
Sultan Ahmed ,OMA,2015,2017,17,16,17,14,0,14,3,3
D Suzuki ,Japan,2022,2024,37,37,17,17,17,0,0,2
R Tari ,VAN,2019,2024,38,38,17,17,17,0,0,2
LV van Beek ,NED,2014,2024,31,31,17,17,17,0,0,3
DJ Willey ,England,2015,2022,43,43,17,17,17,0,0,2
KIC Asalanka ,Sri Lanka,2021,2024,55,55,16,16,16,0,0,3
MNM Aslam ,KUW,2019,2024,61,61,16,16,16,0,0,2
KS Bagabena ,GHA,2019,2024,45,45,16,16,16,0,0,3
PJ Cummins ,Australia,2011,2024,57,57,16,16,16,0,0,2
IK Gamantika ,INA,2022,2024,44,44,16,16,16,0,0,3
DJ Hawoe ,INA,2022,2024,49,49,16,16,16,0,0,3
AJ Hosein ,West Indies,2021,2024,65,61,16,16,16,0,0,2
Imran Ali Butt ,BHR,2019,2024,26,26,16,10,0,10,6,2
JP Inglis ,Australia,2022,2024,29,29,16,15,6,9,1,2
Ishan Kishan ,India,2021,2023,32,31,16,13,4,9,3,3
SS Iyer ,India,2017,2023,51,49,16,16,16,0,0,2
P Khadka ,NEP,2014,2020,33,33,16,16,16,0,0,3
Kuldeep ,PORT,2022,2023,14,14,16,13,0,13,3,3
E Lewis ,West Indies,2016,2024,61,59,16,16,16,0,0,2
Mahedi Hasan ,BAN,2018,2024,51,50,16,16,16,0,0,3
A Mansale ,VAN,2019,2024,34,34,16,16,16,0,0,3
J Marples ,GIBR,2021,2024,20,20,16,12,2,10,4,4
Muslim Yar ,GER,2019,2024,44,44,16,16,16,0,0,3
Najjam Shahzad ,PORT,2019,2024,27,27,16,16,16,0,0,2
Nawroz Mangal ,Afghanistan,2010,2017,32,32,16,16,16,0,0,3
AM Rahane ,India,2011,2016,20,20,16,16,16,0,0,4
WB Rankin (ENG/IRE),NA,2009,2020,50,49,16,16,16,0,0,2
Shafiqullah ,Afghanistan,2010,2019,46,46,16,14,13,1,2,3
KD Shah ,Hong Kong,2014,2023,49,49,16,16,16,0,0,3
Simi Singh ,Ireland,2018,2022,53,53,16,16,16,0,0,2
MWR Stokes ,GUE,2019,2024,38,38,16,16,16,0,0,3
VP Thamotharam ,MLT,2020,2024,55,55,16,16,16,0,0,1
J Vira ,VAN,2019,2024,21,21,16,12,0,12,4,3
Aamir Kaleem ,OMA,2015,2024,36,35,15,15,15,0,0,2
Abdullah Akbarjan ,Aut,2019,2024,35,35,15,15,15,0,0,3
Ahmed Shehzad ,Pakistan,2009,2019,59,59,15,15,15,0,0,2
Arshdeep Singh ,India,2022,2024,60,60,15,15,15,0,0,3
G Bakiweyem ,GHA,2019,2024,41,41,15,15,15,0,0,3
R Bakum ,GHA,2019,2024,42,42,15,15,15,0,0,3
T Bavuma ,South Africa,2019,2023,36,36,15,15,15,0,0,3
TC Bruce ,New Zealand,2017,2020,17,16,15,15,14,1,0,3
PD Collingwood (ENG/World),NA,2005,2017,36,36,15,15,15,0,0,2
JH Davey ,Scotland,2012,2022,31,30,15,15,15,0,0,2
Divyendra Singh ,CZK-R,2022,2024,16,16,15,11,2,9,4,3
Ghulam Shabber ,United Arab Emirates,2016,2019,17,17,15,14,0,14,1,2
OD Hald ,DEN,2019,2024,27,25,15,15,15,0,0,3
SD Hope ,West Indies,2017,2024,39,38,15,14,5,9,1,2
YBK Jaiswal ,India,2023,2024,23,23,15,15,15,0,0,2
Khawar Ali ,OMA,2015,2022,41,40,15,15,15,0,0,2
NR Kumar (CAN/USA),NA,2012,2024,36,36,15,15,15,0,0,2
B Kumar ,India,2012,2022,87,86,15,15,15,0,0,2
Kushal Malla ,NEP,2019,2024,47,47,15,15,15,0,0,2
JN Loftie-Eaton ,Namibia,2021,2024,39,38,15,15,15,0,0,2
BR McDermott ,Australia,2018,2023,25,24,15,15,15,0,0,3
KR Mayers ,West Indies,2020,2024,38,37,15,15,15,0,0,2
GP Meade ,ITA,2019,2024,32,31,15,15,10,5,0,2
DM Nakrani ,UGA,2019,2024,62,61,15,15,15,0,0,1
Nasir Hossain ,BAN,2011,2016,31,30,15,15,15,0,0,2
R Nehonde ,BOT,2019,2024,40,39,15,15,15,0,0,3
SW Poynter ,Ireland,2015,2019,25,23,15,13,5,8,2,2
Ravi Bishnoi ,India,2022,2024,37,37,15,15,15,0,0,2
NA Rock ,Ireland,2021,2024,23,23,15,13,2,11,2,2
Sahir Naqash ,GER,2019,2023,38,38,15,15,15,0,0,2
R Satheesan ,ROM,2019,2023,38,38,15,15,15,0,0,2
BM Scholtz ,Namibia,2019,2024,66,65,15,15,15,0,0,2
SM Sharif ,Scotland,2012,2024,69,68,15,15,15,0,0,2
Sultan Ahmed ,United Arab Emirates,2017,2022,25,25,15,15,15,0,0,3
JTS Sumerauer ,JER,2019,2024,38,38,15,15,15,0,0,2
Taranjeet Singh ,ROM,2021,2024,32,32,15,15,15,0,0,2
CF Tlali ,LES,2021,2024,23,23,15,12,0,12,3,4
Umar Adam ,MDV,2019,2024,46,46,15,15,15,0,0,2
Usman Ghani ,Afghanistan,2015,2023,35,35,15,15,15,0,0,2
CAK Walton ,West Indies,2014,2018,19,19,15,13,3,10,2,3
B Ward ,JER,2019,2024,40,40,15,15,15,0,0,3
MRJ Watt ,Scotland,2015,2024,70,67,15,15,15,0,0,3
SA Wijeyeratne ,Canada,2019,2024,17,17,15,11,1,10,4,3
AP Yadav ,THA,2023,2024,25,25,15,10,1,9,5,2
Yasir Ali ,ESP,2019,2024,38,38,15,15,15,0,0,2
A Zampa ,Australia,2016,2024,95,94,15,15,15,0,0,2
Zeeshan Khan ,MLT,2020,2024,43,43,15,15,15,0,0,3
Ali Naseer ,United Arab Emirates,2023,2024,32,32,14,14,14,0,0,2
Amjad Sher ,FIN,2019,2024,33,33,14,14,14,0,0,2
A Ashokan ,CZK-R,2019,2023,31,31,14,14,14,0,0,2
MA Baig ,MWest Indies,2019,2024,39,39,14,14,14,0,0,3
J Barker ,LUX,2019,2024,36,36,14,14,14,0,0,2
F Behardien ,South Africa,2012,2018,38,38,14,14,14,0,0,2
SVE Bharathi ,GER,2020,2023,37,37,14,14,14,0,0,2
YS Chahal ,India,2016,2023,80,79,14,14,14,0,0,2
F Damiao Couana ,MOZ,2019,2024,38,37,14,14,14,0,0,2
NS Dhaliwal ,Canada,2019,2024,37,37,14,14,14,0,0,1
S Dube ,India,2019,2024,33,32,14,14,14,0,0,2
LA Dunbar ,SRB,2019,2024,29,28,14,14,2,12,0,2
R Escobar ,Arg,2019,2023,17,17,14,10,0,10,4,3
Imran Anwar ,BHR,2019,2024,60,59,14,14,14,0,0,2
Iqbal Hussain ,QAT,2019,2021,26,26,14,14,14,0,0,3
G Kansonkho ,MWest Indies,2019,2024,44,44,14,14,14,0,0,2
Karim Janat ,Afghanistan,2016,2024,66,65,14,14,14,0,0,2
RM Koda ,INA,2022,2024,44,44,14,14,14,0,0,2
KA Maharaj ,South Africa,2021,2024,39,39,14,14,14,0,0,2
Mehidy Hasan Miraz ,BAN,2017,2024,27,27,14,14,14,0,0,2
Misbah-ul-Haq ,Pakistan,2007,2012,39,39,14,14,14,0,0,2
Mohamed Rishwan ,MDV,2019,2024,36,36,14,13,11,2,1,2
YM Nkanya ,TAN,2022,2024,51,49,14,14,14,0,0,2
F Nsubuga ,UGA,2019,2024,56,55,14,14,14,0,0,2
SA Okpe ,NGA,2019,2024,46,45,14,14,14,0,0,2
AR Patwa ,TAN,2021,2024,52,51,14,14,14,0,0,2
Pavandeep Singh ,MAS,2019,2024,65,65,14,14,14,0,0,2
KP Pietersen ,England,2005,2013,37,36,14,14,14,0,0,3
Raza Iqbal ,NOR,2019,2024,31,31,14,14,14,0,0,2
KW Richardson ,Australia,2014,2023,36,36,14,14,14,0,0,2
Ritik Tomar ,CZK-R,2022,2024,22,22,14,14,14,0,0,2
R Sandaruwan ,KUW,2019,2024,65,65,14,14,14,0,0,2
M Theekshana ,Sri Lanka,2021,2024,57,57,14,14,14,0,0,2
DC Thomas ,West Indies,2009,2022,12,12,14,12,0,12,2,3
NT Tilak Varma ,India,2023,2024,20,20,14,14,14,0,0,2
Vraj Patel ,Kenya,2021,2024,53,52,14,14,14,0,0,2
LJ Wright ,England,2007,2014,51,50,14,14,14,0,0,2
M Yunusu Issa ,TAN,2022,2024,40,38,14,14,14,0,0,2
Zeeshan Maqsood ,OMA,2015,2024,73,72,14,14,14,0,0,2
P Zuze ,MWest Indies,2023,2024,18,18,14,13,0,13,1,2
Abdul-Shakoor Rahimzei ,GER,2019,2023,26,26,13,13,13,0,0,2
Ahmed Hassan ,SUI,2023,2024,11,11,13,13,0,13,0,3
Ahmer Bin ,BHR,2022,2024,36,35,13,13,4,9,0,3
Ahsan Malik ,NED,2012,2017,31,30,13,13,13,0,0,2
DK Anefie ,GHA,2019,2023,36,36,13,13,13,0,0,3
Anjar Tadarus ,INA,2022,2024,43,43,13,13,13,0,0,3
SJ Baard ,Namibia,2019,2022,28,28,13,13,13,0,0,2
M Beitaki ,Fiji,2022,2024,16,16,13,10,4,6,3,3
WAE Burton ,SRB,2021,2024,26,25,13,12,11,1,1,2
J Butler ,GUE,2019,2024,35,35,13,13,13,0,0,2
MJ Clarke ,Australia,2005,2010,34,34,13,13,13,0,0,2
NM Coulter-Nile ,Australia,2013,2019,28,27,13,13,13,0,0,2
S Davizi ,CZK-R,2019,2024,32,32,13,13,13,0,0,2
N Dickwella ,Sri Lanka,2016,2021,28,28,13,12,1,11,1,2
Dylan Steyn ,CZK-R,2022,2024,21,21,13,13,13,0,0,3
LH Ferguson ,New Zealand,2017,2024,43,43,13,13,13,0,0,2
JEC Franklin ,New Zealand,2006,2013,38,38,13,13,13,0,0,2
US Hathinjar ,CAM,2023,2024,25,24,13,11,0,11,2,3
LM Jongwe ,Zimbabwe,2015,2024,65,65,13,13,13,0,0,2
C Karunaratne ,Sri Lanka,2021,2023,42,42,13,13,13,0,0,2
Khizar Hayat ,MAS,2020,2024,47,46,13,13,13,0,0,2
AR McBrine ,Ireland,2014,2022,32,31,13,13,13,0,0,2
Manan Ali ,KSA,2023,2024,27,27,13,12,8,4,1,2
JF Mooney ,Ireland,2009,2015,27,27,13,13,13,0,0,2
Mosaddek Hossain ,BAN,2016,2022,33,33,13,13,13,0,0,2
S Movva ,Canada,2021,2024,16,15,13,11,0,11,2,3
A Nanda ,LUX,2019,2024,31,31,13,13,13,0,0,2
MA Ouma ,Kenya,2007,2013,22,22,13,8,0,8,5,2
BA Pai ,GIBR,2019,2024,39,39,13,13,13,0,0,2
TD Paine (AUS/World),NA,2009,2017,12,12,13,11,0,11,2,3
SP Patil ,United Arab Emirates,2014,2016,18,18,13,9,0,9,4,2
GA Priandana ,INA,2022,2024,35,35,13,13,13,0,0,2
RR Rossouw ,South Africa,2014,2023,29,29,13,13,13,0,0,3
Shahil Momin ,Aut,2021,2023,24,24,13,13,13,0,0,3
A Sharafu ,United Arab Emirates,2020,2024,34,34,13,13,13,0,0,2
Suraj Kumar ,OMA,2019,2022,19,19,13,11,0,11,2,3
Tamoor Sajjad ,QAT,2019,2020,16,16,13,13,13,0,0,2
C Tommy ,VAN,2019,2024,24,24,13,12,6,6,1,2
T Tshose ,BOT,2019,2024,27,26,13,13,13,0,0,2
M Vaik ,EST,2021,2024,18,18,13,12,1,11,1,3
Wahidullah Sahak ,NOR,2021,2024,16,16,13,13,13,0,0,3
Abdul Shakoor ,ROM,2019,2023,19,19,12,8,3,5,4,3
JD Allan ,VAN,2022,2024,16,16,12,9,0,9,3,2
Aqib Iqbal ,Aut,2019,2024,43,43,12,12,12,0,0,3
Arslan Amjad ,EST,2022,2024,19,19,12,12,12,0,0,2
Azmatullah Omarzai ,Afghanistan,2022,2024,44,44,12,12,12,0,0,2
O Bascome ,BER,2019,2021,17,17,12,9,2,7,3,3
EF Beard ,IOM,2021,2024,23,22,12,12,12,0,0,2
E Beukes ,CAM,2023,2024,25,24,12,12,12,0,0,2
Bilal Khan ,OMA,2015,2024,79,78,12,12,12,0,0,2
TLW Cooper ,NED,2012,2022,33,32,12,12,12,0,0,2
KC D'Souza ,BUL,2020,2022,36,35,12,12,12,0,0,3
Faheem Ashraf ,Pakistan,2017,2023,48,48,12,12,12,0,0,2
PF Gallagher ,FIN,2019,2023,22,22,12,12,12,0,0,3
CN Greaves ,Scotland,2021,2024,30,29,12,12,12,0,0,2
C Hartmann ,IOM,2020,2024,22,21,12,10,3,7,2,2
Hasan Ali ,Pakistan,2016,2024,51,51,12,12,12,0,0,1
Haseeb Ghafoor ,KSA,2022,2024,20,20,12,9,0,9,3,2
JR Hazlewood ,Australia,2013,2024,52,52,12,12,12,0,0,1
DJ Hooda ,India,2022,2023,21,21,12,12,12,0,0,3
JJ Huo ,MOZ,2019,2024,37,36,12,12,12,0,0,2
S Ivetic ,SRB,2022,2024,14,14,12,12,12,0,0,3
Junaid Siddique ,United Arab Emirates,2019,2024,63,63,12,12,12,0,0,2
L Karlsson ,SWE,2021,2022,16,16,12,12,12,0,0,2
DK Kesuma ,INA,2023,2024,27,27,12,12,11,1,0,2
PK Langat ,Kenya,2021,2024,35,33,12,12,12,0,0,2
Kuldeep Yadav ,India,2017,2024,40,39,12,12,12,0,0,2
IDM Latin ,GIBR,2022,2024,25,25,12,12,12,0,0,2
KS Leverock ,BER,2019,2023,29,29,12,12,12,0,0,2
D Maisuria ,BOT,2019,2023,37,36,12,12,12,0,0,2
BJ McCarthy ,Ireland,2017,2024,56,56,12,12,12,0,0,2
PHKD Mendis ,Sri Lanka,2018,2024,21,21,12,12,12,0,0,2
Mohameed Taiwo ,NGA,2019,2024,29,29,12,12,12,0,0,2
Muhammad Usman ,United Arab Emirates,2016,2022,47,47,12,12,12,0,0,2
Mukhtar Ghulami ,Fran,2023,2024,15,15,12,12,12,0,0,4
B Muzarabani ,Zimbabwe,2018,2024,61,61,12,12,12,0,0,2
Nadeem Ahmed ,Hong Kong,2014,2017,24,24,12,12,12,0,0,2
N Nuntarach ,THA,2022,2024,28,28,12,12,12,0,0,2
LN Oluoch ,Kenya,2013,2024,64,63,12,12,12,0,0,1
JDP Oram ,New Zealand,2005,2012,36,36,12,12,12,0,0,2
Rishad Hossain ,BAN,2023,2024,27,27,12,12,12,0,0,2
Saeed Ajmal ,Pakistan,2009,2015,64,64,12,12,12,0,0,2
MN Samuels ,West Indies,2007,2018,67,67,12,12,12,0,0,2
T Sandeep ,SWZ,2022,2024,16,15,12,11,3,8,1,4
JOP Scamans ,FIN,2019,2024,18,18,12,10,0,10,2,2
Shahid Wasif ,Hong Kong,2016,2023,24,24,12,12,12,0,0,2
T Shamsi ,South Africa,2017,2024,70,70,12,12,12,0,0,2
MW Short ,Australia,2023,2024,14,14,12,12,12,0,0,3
V Sibanda ,Zimbabwe,2007,2016,26,26,12,12,12,0,0,3
OF Smith ,West Indies,2018,2023,27,27,12,12,12,0,0,3
KJ Stagno ,GIBR,2022,2024,25,25,12,10,1,9,2,2
DW Steyn ,South Africa,2007,2020,47,47,12,12,12,0,0,1
T van der Gugten ,NED,2012,2024,49,48,12,12,12,0,0,2
M van Lingen ,Namibia,2021,2024,30,30,12,12,12,0,0,2
HA Varaiya ,Kenya,2007,2013,25,25,12,12,12,0,0,2
Waseem Abbas ,MLT,2019,2024,50,50,12,12,12,0,0,2
CR Woakes ,England,2011,2023,33,33,12,12,12,0,0,3
Younis Khan ,Pakistan,2006,2010,25,25,12,12,12,0,0,2
Yuvraj Singh ,India,2007,2017,58,57,12,12,12,0,0,2
Sarfraz Butt ,KSA,2020,2023,10,10,12,5,0,5,7,3
SA Abbott ,Australia,2014,2024,20,20,11,11,11,0,0,4
R Abdulkareem ,NGA,2021,2024,33,32,11,11,11,0,0,2
B Arora ,MLT,2019,2024,56,56,11,11,11,0,0,2
R Ashwin ,India,2010,2022,65,65,11,11,11,0,0,1
Avesh Khan ,India,2022,2024,25,24,11,11,11,0,0,2
A Bagai ,Canada,2008,2013,9,9,11,5,0,5,6,2
A Bohara ,NEP,2019,2024,62,62,11,11,11,0,0,1
MG Bracewell ,New Zealand,2022,2024,24,23,11,11,11,0,0,3
PVD Chameera ,Sri Lanka,2015,2024,55,55,11,11,11,0,0,2
D Cleaver ,New Zealand,2022,2023,9,9,11,9,0,9,2,3
Dawood Ahmadzai ,Fran,2021,2024,27,27,11,11,11,0,0,2
AC Douglas ,BER,2019,2023,21,21,11,11,11,0,0,3
AC Evans ,Scotland,2015,2022,35,33,11,11,11,0,0,2
Faisal Khan ,KSA,2019,2024,41,41,11,11,11,0,0,2
JP Faulkner ,Australia,2012,2017,24,24,11,11,11,0,0,2
RD Gaikwad ,India,2021,2024,23,22,11,11,11,0,0,3
G Gambhir ,India,2007,2012,37,36,11,11,11,0,0,2
Ghulam Ahmadi ,GER,2021,2024,44,44,11,11,11,0,0,2
S Hook ,EST,2021,2024,24,24,11,10,5,5,1,2
Imran Nazir ,Pakistan,2007,2012,25,25,11,11,11,0,0,2
D Jakiel (MWI/ZIM),NA,2019,2024,35,35,11,11,11,0,0,2
M Jansen ,South Africa,2022,2024,17,17,11,11,11,0,0,2
Jaspal Singh ,MLT,2023,2024,24,24,11,11,11,0,0,2
SA Jumbe ,TAN,2021,2024,56,54,11,11,11,0,0,2
Junaid Aziz ,BHR,2020,2024,38,37,11,11,11,0,0,2
Khizer Ahmed ,NOR,2019,2024,17,17,11,7,1,6,4,3
Luqman Butt ,CAM,2023,2024,25,24,11,11,11,0,0,3
AF Milne ,New Zealand,2010,2024,53,51,11,11,11,0,0,2
PL Mommsen ,Scotland,2012,2016,24,22,11,11,11,0,0,2
Muhammad Muneeb ,Belg,2020,2024,32,32,11,11,11,0,0,2
GM Mwendwa ,Kenya,2022,2024,27,27,11,11,11,0,0,1
A Natubhai Ahir ,PAN,2019,2023,16,16,11,6,3,3,5,2
K Nestor ,GIBR,2019,2024,33,33,11,11,11,0,0,1
E Niyomugabo ,RWN,2021,2023,48,47,11,11,11,0,0,1
P Murungi ,UGA,2022,2023,31,30,11,11,11,0,0,2
Qamar Mushtaque ,NOR,2022,2024,18,18,11,11,11,0,0,2
R Ravindra ,New Zealand,2021,2024,23,22,11,11,11,0,0,2
Razmal Shigiwal ,Aut,2019,2023,39,39,11,11,11,0,0,3
EB Ringera ,Kenya,2019,2024,35,34,11,11,11,0,0,3
Rizwan Cheema ,Canada,2008,2019,24,24,11,11,11,0,0,2
Saim Ayub ,Pakistan,2023,2024,23,23,11,11,11,0,0,4
S Samarawickrama ,Sri Lanka,2017,2024,19,19,11,9,6,3,2,2
Sayed Monib ,KUW,2020,2024,38,38,11,11,11,0,0,2
RA Sealy ,CAY,2022,2023,13,13,11,10,8,2,1,2
Shahbaz Badar ,BHR,2019,2024,16,16,11,8,0,8,3,3
Shaiman Anwar ,United Arab Emirates,2014,2019,32,32,11,11,11,0,0,2
Sheraz Sheikh ,Belg,2021,2024,30,30,11,11,11,0,0,2
Sher Sahak ,NOR,2021,2024,26,26,11,11,11,0,0,2
Shoaib Khan ,OMA,2022,2024,28,28,11,11,11,0,0,2
Syed Haider ,United Arab Emirates,2024,2024,13,13,11,10,0,10,1,4
T Taibu ,Zimbabwe,2007,2012,17,17,11,6,0,6,5,3
MB Tambe ,FIN,2021,2024,26,26,11,11,11,0,0,2
Taskin Ahmed ,BAN,2014,2024,70,68,11,11,11,0,0,2
AM Tribe ,JER,2021,2024,25,25,11,9,7,2,2,3
Tshering Tashi (2) ,BHU,2024,2024,9,9,11,9,0,9,2,3
Arjun Vinod ,SUI,2021,2024,22,22,11,11,11,0,0,2
D Weston ,GER,2019,2019,6,6,11,9,0,9,2,4
CA Young ,Ireland,2015,2024,66,65,11,11,11,0,0,2
Zaheer Ibrahim ,QAT,2019,2021,24,24,11,11,11,0,0,3
Aarif Sheikh ,NEP,2018,2024,41,41,10,10,10,0,0,1
Abdur Razzak ,BAN,2006,2014,34,33,10,10,10,0,0,2
Adnan Idrees ,KUW,2019,2024,38,38,10,10,10,0,0,1
NK Aneesh Kumar ,SUI,2021,2024,21,21,10,10,10,0,0,3
CV Anto ,KUW,2023,2024,27,27,10,10,10,0,0,2
SE Aquilina ,MLT,2019,2021,16,16,10,4,0,4,6,2
SKA Awiah ,GHA,2021,2024,40,40,10,10,10,0,0,1
GJ Bailey (AUS/World),NA,2012,2017,30,30,10,10,10,0,0,2
SJ Benn ,West Indies,2008,2016,24,24,10,10,10,0,0,3
C Brennan ,JER,2021,2024,23,23,10,10,10,0,0,2
TT Bresnan ,England,2006,2014,34,34,10,10,10,0,0,2
RL Chase ,West Indies,2021,2024,29,28,10,10,10,0,0,2
M Choamba ,MWest Indies,2021,2024,32,32,10,10,10,0,0,2
WJ Cope ,LUX,2020,2024,33,33,10,10,10,0,0,2
JW Dernbach (ENG/ITA),NA,2011,2021,40,39,10,10,10,0,0,2
E Dusingizimana ,RWN,2021,2023,58,57,10,10,10,0,0,2
Fiaz Ahmed ,BHR,2019,2024,15,15,10,10,10,0,0,2
GC Galanis ,GRC,2019,2024,14,14,10,10,10,0,0,2
GK Ghalley ,BHU,2022,2024,19,19,10,10,10,0,0,3
SKS Gill ,LUX,2022,2024,29,29,10,10,10,0,0,3
NA Greenwood ,JER,2019,2024,31,31,10,10,10,0,0,3
Gulsan Jha ,NEP,2022,2024,38,38,10,10,10,0,0,2
Habib Khan ,EST,2021,2024,17,17,10,10,10,0,0,3
Hilal Ahmad ,CZK-R,2019,2021,15,15,10,8,1,7,2,3
Jaker Ali ,BAN,2023,2024,19,19,10,8,4,4,2,1
T Jamtsho ,BHU,2019,2024,26,26,10,10,10,0,0,1
S Jora ,NEP,2019,2024,31,31,10,10,10,0,0,2
AS Joseph ,West Indies,2022,2024,35,34,10,10,10,0,0,1
I Kaia ,Zimbabwe,2021,2024,19,19,10,10,10,0,0,3
Kamran Khan ,QAT,2019,2024,36,36,10,10,10,0,0,2
WJ Malinda ,MDV,2019,2023,11,11,10,10,10,0,0,5
Mashrafe Mortaza ,BAN,2006,2017,54,53,10,10,10,0,0,3
G Mckeon ,Fran,2022,2024,20,20,10,10,10,0,0,2
Mohammad Amir ,Pakistan,2009,2024,62,62,10,10,10,0,0,2
Mohammad Saifuddin ,BAN,2017,2024,38,38,10,10,10,0,0,2
Mohammed Nadeem ,QAT,2019,2024,35,35,10,10,10,0,0,2
SJ Myburgh ,NED,2012,2022,45,44,10,10,10,0,0,2
LJ Myott ,PHI,2023,2024,16,16,10,10,10,0,0,2
Nasrulla Rana ,Hong Kong,2019,2024,42,41,10,10,10,0,0,1
D Nikolov ,BUL,2019,2024,30,29,10,10,10,0,0,2
P Nissanka ,Sri Lanka,2021,2024,59,59,10,10,10,0,0,3
W Niyitanga ,RWN,2021,2024,61,60,10,10,10,0,0,3
A Nortje ,South Africa,2019,2024,42,42,10,10,10,0,0,1
R Obuya ,UGA,2023,2024,23,23,10,10,10,0,0,2
NN Odhiambo ,Kenya,2007,2022,43,42,10,10,10,0,0,1
IO Okpe ,NGA,2019,2024,49,48,10,10,10,0,0,3
JL Ontong ,South Africa,2008,2015,14,14,10,10,10,0,0,3
R Panchal ,ESP,2019,2023,22,22,10,10,10,0,0,2
RJ Peterson ,South Africa,2006,2014,21,21,10,10,10,0,0,2
C Pyle ,GIBR,2024,2024,8,8,10,4,0,4,6,2
PBB Rajapaksa ,Sri Lanka,2019,2024,42,41,10,10,10,0,0,1
J Rasu ,VAN,2019,2024,39,39,10,10,10,0,0,1
JA Richardson ,Australia,2017,2022,18,18,10,10,10,0,0,2
AK Sah ,NEP,2018,2024,12,12,10,10,10,0,0,3
Sandeep Goud ,OMA,2019,2024,30,30,10,10,10,0,0,2
A Sharma ,United Arab Emirates,2023,2024,12,12,10,8,0,8,2,2
R Sharma ,SGP,2023,2024,11,11,10,10,10,0,0,2
H Singh ,GER,2019,2024,36,36,10,10,10,0,0,2
J Singye ,BHU,2019,2024,18,18,10,10,10,0,0,2
H Srinivasan ,GER,2019,2021,8,8,10,6,0,6,4,2
I Takahashi ,Japan,2022,2024,37,37,10,10,10,0,0,2
SR Taylor ,United States of America,2019,2024,30,30,10,10,10,0,0,2
H Thaker ,Canada,2019,2024,35,34,10,10,10,0,0,2
AN Toube ,CAM,2021,2024,22,22,10,9,3,6,1,2
AJ Tye ,Australia,2016,2021,32,31,10,10,10,0,0,2
S Vijay Unni ,MAS,2022,2024,43,43,10,10,10,0,0,1
Vinay Ravi ,NOR,2021,2024,23,23,10,10,10,0,0,2
L Yamamoto-Lake ,Japan,2022,2024,36,36,10,10,10,0,0,2
SA Ahmad ,DEN,2019,2024,33,31,9,9,9,0,0,1
Ali Dawood ,BHR,2023,2024,25,25,9,9,9,0,0,3
Amar Sharma ,MLT,2020,2023,36,36,9,9,9,0,0,2
Amir Zaib ,PORT,2021,2024,23,23,9,9,9,0,0,1
AJ Ayannaike ,NGA,2019,2021,20,20,9,8,3,5,1,3
V Balakrishnan ,BOT,2019,2024,30,29,9,9,9,0,0,3
T Banton ,England,2019,2022,14,13,9,9,7,2,0,2
P Baron ,Arg,2019,2024,20,20,9,8,7,1,1,2
LT Bichard ,GUE,2020,2024,28,28,9,9,9,0,0,3
Mudassar Bukhari ,NED,2008,2016,38,36,9,9,9,0,0,2
JJ Bumrah ,India,2016,2024,70,69,9,9,9,0,0,2
G Burrows ,IOM,2020,2024,21,20,9,9,9,0,0,2
TD Chaoana ,LES,2021,2024,22,22,9,9,9,0,0,2
CJ Chibhabha ,Zimbabwe,2006,2020,36,36,9,9,9,0,0,2
M Coetzee ,Hong Kong,2023,2024,28,27,9,9,9,0,0,1
M Cope ,LUX,2019,2024,13,13,9,9,9,0,0,2
BJ Currie ,Scotland,2023,2024,15,14,9,9,9,0,0,2
A Davidson Soler ,ESP,2024,2024,9,9,9,4,0,4,5,3
S Desungnoen ,THA,2020,2024,22,22,9,9,9,0,0,2
Fayyaz Butt ,OMA,2019,2024,47,47,9,9,9,0,0,2
JA Fitzgerald ,GIBR,2019,2024,34,34,9,9,9,0,0,1
HS Gericke ,MLT,2020,2022,21,21,9,8,1,7,1,2
SC Getkate ,Ireland,2019,2022,30,30,9,9,9,0,0,2
Hassan Rasheed ,MDV,2019,2024,32,32,9,8,3,5,1,2
Jasdeep Singh ,United States of America,2019,2024,25,25,9,9,9,0,0,2
J Jemison ,Bhm,2022,2023,9,9,9,4,0,4,5,3
DT Johnston ,Ireland,2008,2013,30,28,9,9,9,0,0,3
N Khanna ,MLT,2019,2023,24,24,9,9,9,0,0,2
PD McGlashan ,New Zealand,2006,2010,11,11,9,9,0,9,0,3
HJ Manenti ,ITA,2022,2024,15,15,9,9,9,0,0,2
T Marumani ,Zimbabwe,2021,2024,36,36,9,7,6,1,2,2
AS Mehmi ,GRC,2019,2024,15,15,9,9,9,0,0,2
Mehran Khan ,OMA,2015,2024,45,44,9,9,9,0,0,1
SR Mohan ,SEY,2021,2024,15,15,9,5,1,4,4,2
M Mooketsi ,BOT,2019,2024,38,37,9,9,9,0,0,1
J Mubarak ,Sri Lanka,2007,2009,16,16,9,9,9,0,0,2
Muhammad Nadir ,RWN,2023,2024,36,36,9,9,9,0,0,1
Murid Ekrami ,Belg,2019,2024,25,25,9,9,9,0,0,2
A Mutreja ,SGP,2022,2024,13,13,9,9,9,0,0,2
SN Netravalkar ,United States of America,2019,2024,36,36,9,9,9,0,0,1
R Ngarava ,Zimbabwe,2019,2024,60,60,9,9,9,0,0,2
MK Pandey ,India,2015,2020,39,39,9,9,9,0,0,2
NK Patel ,United States of America,2019,2024,21,21,9,9,9,0,0,2
YK Pathan ,India,2007,2012,22,22,9,9,9,0,0,2
BM Pecic ,SRB,2024,2024,7,7,9,9,0,9,0,3
AL Phehlukwayo ,South Africa,2017,2024,42,42,9,9,9,0,0,2
MJ Prior ,England,2007,2010,10,10,9,6,0,6,3,4
Rahmatullah Mangal ,Fran,2021,2024,19,19,9,9,9,0,0,2
Rizwan Butt ,BHR,2022,2024,39,38,9,9,9,0,0,1
Sahel Zadran ,Aut,2021,2023,28,28,9,9,9,0,0,2
Saim Hussain ,BUL,2022,2023,18,17,9,8,0,8,1,2
G Sesay ,Sri LankaE,2021,2024,34,34,9,9,9,0,0,2
B Shikongo ,Namibia,2019,2024,33,32,9,9,9,0,0,1
Shoriful Islam ,BAN,2021,2024,42,41,9,9,9,0,0,2
CJO Smith ,Scotland,2007,2009,8,7,9,5,0,5,4,2
DC Smith ,PHI,2019,2024,30,30,9,9,9,0,0,2
S Smith ,BER,2019,2023,15,15,9,5,0,5,4,2
MC Sorensen ,Ireland,2012,2016,26,24,9,9,9,0,0,2
T Suri ,United Arab Emirates,2023,2024,7,7,9,7,0,7,2,2
Syazrul Idrus ,MAS,2019,2023,33,33,9,9,9,0,0,2
Tanzim Hasan Sakib ,BAN,2023,2024,15,15,9,9,9,0,0,2
JE Taylor ,West Indies,2006,2018,30,30,9,9,9,0,0,1
A Venkatesh ,SWE,2021,2022,16,16,9,9,9,0,0,3
S Vesawkar ,NEP,2014,2022,20,20,9,9,9,0,0,2
DL Vettori ,New Zealand,2007,2014,34,34,9,9,9,0,0,2
Vikramjit Singh ,NED,2019,2024,23,23,9,9,9,0,0,2
CD Wallace ,Scotland,2012,2021,21,20,9,7,1,6,2,2
MN Waller ,Zimbabwe,2011,2018,32,32,9,9,9,0,0,1
HR Walsh (USA/WI),NA,2019,2024,39,35,9,9,9,0,0,2
T Wangchuk ,BHU,2022,2024,25,25,9,9,9,0,0,2
Y Saranonnakkun ,THA,2022,2024,29,29,9,9,9,0,0,1
Zeeshan Kukikhel ,HUN,2021,2023,15,14,9,9,9,0,0,2
Aaron Jones ,United States of America,2019,2024,39,39,8,8,8,0,0,1
Abbas Ghani ,HUN,2023,2024,6,6,8,8,8,0,0,2
P Aho ,NGA,2021,2024,38,37,8,8,8,0,0,2
MJ Ansell ,IOM,2020,2024,22,21,8,8,8,0,0,3
Ansh Tandon ,United Arab Emirates,2020,2023,9,9,8,8,8,0,0,3
U Aryaman Sunil ,SGP,2019,2022,25,25,8,8,8,0,0,2
Basil George ,MLT,2021,2024,34,34,8,8,8,0,0,2
Bilal Hassun ,UGA,2021,2024,46,44,8,8,8,0,0,1
D Birrell ,JER,2021,2024,15,15,8,8,8,0,0,2
AC Botha ,Ireland,2008,2010,14,13,8,8,8,0,0,2
JA Burrows ,IOM,2020,2024,24,23,8,8,8,0,0,2
M Campopiano ,ITA,2022,2024,19,19,8,8,8,0,0,2
HL Carlyon ,JER,2019,2024,39,39,8,8,8,0,0,2
G Chaturvedi ,MLT,2019,2022,19,19,8,8,8,0,0,3
R Chopra ,United Arab Emirates,2024,2024,10,10,8,8,8,0,0,4
TK Curran ,England,2017,2021,30,29,8,8,8,0,0,1
L Denny ,COK,2022,2024,12,12,8,8,8,0,0,3
NT Ellis ,Australia,2021,2024,20,20,8,8,8,0,0,2
WIA Fernando ,Sri Lanka,2019,2024,35,34,8,8,8,0,0,2
Fitri Sham ,MAS,2019,2024,45,43,8,8,8,0,0,1
A Gbla ,Sri LankaE,2021,2024,28,28,8,8,8,0,0,3
HH Gibbs ,South Africa,2005,2010,23,23,8,8,8,0,0,3
S Grover ,CZK-R,2021,2024,9,9,8,8,5,3,0,3
Haider Ali ,Pakistan,2020,2023,35,35,8,8,8,0,0,1
TM Head ,Australia,2016,2024,38,38,8,8,8,0,0,2
D Heyliger ,Canada,2019,2024,45,44,8,8,8,0,0,2
H Hiri ,Papau New Guinea,2016,2024,28,28,8,8,8,0,0,2
Ibrahim Jabarkhel ,Fran,2021,2023,12,12,8,8,8,0,0,2
Ibrahim Nashath ,MDV,2019,2024,22,22,8,8,8,0,0,1
A Ilaoa ,Samoa,2023,2024,7,7,8,7,0,7,1,5
K Irakoze ,RWN,2021,2024,75,74,8,8,8,0,0,1
S Jamil ,Belg,2019,2024,12,12,8,8,1,7,0,2
A Johnson ,Canada,2022,2024,25,24,8,8,8,0,0,2
Jordan O'Brien ,FIN,2023,2024,13,13,8,7,3,4,1,3
K Kadowaki-Fleming ,Japan,2022,2024,35,35,8,8,8,0,0,2
Khalid Ahmadi ,Belg,2020,2024,34,34,8,8,8,0,0,1
NR Kirton ,Canada,2019,2024,25,24,8,8,8,0,0,1
D Klein ,GER,2020,2023,23,23,8,8,8,0,0,2
FA Klokker ,DEN,2021,2022,13,13,8,6,4,2,2,4
M Kpaka ,Sri LankaE,2021,2023,21,21,8,8,8,0,0,2
AV Lazarus ,THA,2024,2024,21,21,8,8,8,0,0,2
Luka Woods ,SRB,2024,2024,8,8,8,8,8,0,0,3
MJ Lumb ,England,2010,2014,27,26,8,8,8,0,0,1
T Lungameni ,Namibia,2019,2024,38,38,8,8,8,0,0,2
DV Macome ,MOZ,2022,2024,18,18,8,8,8,0,0,1
JS Malhotra ,United States of America,2019,2022,17,17,8,5,3,2,3,2
A Manepalli ,LUX,2020,2024,8,8,8,8,0,8,0,3
Manoj Adhikari ,BHU,2022,2024,11,11,8,4,0,4,4,3
B McMullen ,Scotland,2023,2024,16,15,8,8,8,0,0,2
KD Mills ,New Zealand,2005,2014,42,42,8,8,8,0,0,1
Mohammad Ihsan ,ESP,2022,2024,21,20,8,5,5,0,3,2
AJ Mosca ,ITA,2022,2024,13,13,8,8,8,0,0,2
M Mosehle ,South Africa,2017,2017,7,7,8,6,0,6,2,3
Musa Shaheen ,DEN,2019,2023,21,21,8,8,8,0,0,2
Naveed Ahmed ,CZK-R,2019,2024,38,38,8,8,8,0,0,2
Naveen-ul-Haq ,Afghanistan,2019,2024,45,45,8,8,8,0,0,2
L Ngidi ,South Africa,2017,2024,43,43,8,8,8,0,0,1
FFZ Nhaduate ,MOZ,2023,2024,8,8,8,6,0,6,2,4
Nouman Sarwar ,QAT,2019,2024,16,16,8,8,8,0,0,2
GM Ntambalika ,MWest Indies,2019,2024,29,29,8,8,8,0,0,2
O Harvey ,GHA,2021,2024,42,42,8,8,8,0,0,2
Omid Mailk Khel ,Belg,2022,2024,12,12,8,5,0,5,3,2
AA Onikoyi ,NGA,2019,2023,29,28,8,8,6,2,0,1
CN Onwuzulike ,NGA,2019,2022,22,22,8,8,8,0,0,3
E Otgonbayar ,MNG,2023,2024,9,9,8,8,0,8,0,3
KH Pandya ,India,2018,2021,19,19,8,8,8,0,0,2
SN Pathirana ,CYP,2021,2024,19,19,8,6,0,6,2,2
T Perera ,BOT,2019,2024,17,16,8,8,8,0,0,2
N Pokana ,Papau New Guinea,2016,2024,31,31,8,8,8,0,0,2
RT Ponting ,Australia,2005,2009,17,17,8,8,8,0,0,2
Qais Ahmad ,Afghanistan,2020,2024,11,10,8,8,8,0,0,3
Rameez Shahzad ,United Arab Emirates,2016,2019,22,22,8,8,8,0,0,2
A Reyes ,GIBR,2021,2024,24,24,8,8,8,0,0,2
R Rohan ,SGP,2019,2024,29,29,8,8,8,0,0,1
C Rumistrzewicz ,ESP,2021,2024,26,25,8,8,8,0,0,2
R Sakurano-Thomas ,Japan,2022,2024,35,35,8,8,8,0,0,3
Ali Nayyer ,SUI,2021,2024,21,21,8,8,8,0,0,2
P Sarraf ,NEP,2019,2022,17,17,8,8,8,0,0,4
S Rungrueang ,THA,2023,2024,19,19,8,8,8,0,0,2
R Shepherd ,West Indies,2020,2024,50,46,8,8,8,0,0,1
DJM Short ,Australia,2018,2020,23,22,8,8,8,0,0,2
DR Smith ,West Indies,2006,2015,33,33,8,8,8,0,0,1
SSM Stanislaus ,MLT,2020,2024,40,40,8,8,8,0,0,1
SB Styris ,New Zealand,2005,2010,31,31,8,8,8,0,0,2
Swann Htet Ko Ko ,MYAN,2023,2024,15,15,8,6,1,5,2,2
M Taniyama ,Japan,2022,2024,30,30,8,8,8,0,0,1
M Taylor ,Bhm,2021,2023,15,15,8,8,8,0,0,2
RML Taylor ,Scotland,2013,2016,9,9,8,8,8,0,0,2
Tenjin Rabgey ,BHU,2022,2024,25,25,8,8,8,0,0,1
HDRL Thirimanne ,Sri Lanka,2012,2016,26,26,8,8,8,0,0,1
R Trumpelmann ,Namibia,2021,2024,32,31,8,8,8,0,0,1
Umair Qasim (SWA/SWZ),NA,2021,2024,22,21,8,8,8,0,0,2
Umair Tariq ,Aut,2021,2024,18,18,8,8,8,0,0,1
P Useni ,NGA,2021,2024,38,37,8,8,8,0,0,1
Usman Khan ,Fran,2021,2024,22,22,8,8,8,0,0,1
Utkarsh Jain ,CAM,2023,2024,16,16,8,8,8,0,0,2
Waqas Barkat ,Hong Kong,2014,2020,30,30,8,8,8,0,0,2
S Wickramasekara ,CZK-R,2019,2023,34,34,8,8,8,0,0,2
KOK Williams ,West Indies,2016,2020,26,26,8,8,8,0,0,1
C Wright ,CAY,2019,2023,18,18,8,8,8,0,0,1
MH Yardy ,England,2006,2011,14,14,8,8,8,0,0,2
Yasim Murtaza ,Hong Kong,2022,2024,47,46,8,8,8,0,0,2
Zahoor Khan ,United Arab Emirates,2017,2023,57,57,8,8,8,0,0,1
KJ Abbott ,South Africa,2013,2016,21,21,7,7,7,0,0,2
CN Ackermann ,NED,2019,2024,25,25,7,7,7,0,0,1
RG Aga ,Kenya,2008,2013,20,20,7,7,7,0,0,2
Ali Masood ,EST,2021,2024,23,23,7,7,7,0,0,2
A Andrews ,SUI,2021,2022,7,7,7,7,7,0,0,2
Anique Uddin ,DEN,2019,2023,13,12,7,7,7,0,0,3
Anwar Rahman ,MAS,2019,2023,22,21,7,7,7,0,0,2
S Ashwathnarayana ,HUN,2021,2022,14,13,7,7,0,7,0,2
Atif-Ur-Rehman ,KSA,2022,2024,19,19,7,7,7,0,0,2
F Baaleri ,GHA,2019,2024,9,9,7,7,2,5,0,4
S Badree (WI/World),NA,2012,2018,52,52,7,7,7,0,0,2
HS Baidwan ,Canada,2008,2013,17,17,7,7,7,0,0,2
XC Bartlett ,Australia,2024,2024,7,7,7,7,7,0,0,2
JP Behrendorff ,Australia,2017,2024,17,16,7,7,7,0,0,3
BJ Bennett ,Zimbabwe,2023,2024,21,21,7,7,7,0,0,1
Bilal Muhammad ,MLT,2021,2022,31,31,7,7,7,0,0,2
S Bodha ,GIBR,2022,2024,29,29,7,7,7,0,0,2
RS Bopara ,England,2008,2014,38,37,7,7,7,0,0,2
DAJ Bracewell ,New Zealand,2011,2021,20,19,7,7,7,0,0,2
SSJ Brooks ,West Indies,2021,2022,13,13,7,7,7,0,0,1
J Bulele ,MOZ,2019,2022,27,26,7,7,7,0,0,2
LA Burns ,ESP,2022,2024,28,28,7,7,7,0,0,2
J Butler ,IOM,2020,2023,15,15,7,7,7,0,0,2
L Canessane ,Fran,2021,2024,26,26,7,7,5,2,0,1
CPPM Sadun ,CYP,2021,2024,17,17,7,7,7,0,0,2
S Chanderpaul ,West Indies,2006,2010,22,22,7,7,7,0,0,1
TL Chatara ,Zimbabwe,2010,2024,60,60,7,7,7,0,0,2
R Coker ,Sri LankaE,2022,2024,24,24,7,7,7,0,0,2
NRJ Croes ,NED,2024,2024,9,9,7,7,7,0,0,2
AR Cusack ,Ireland,2008,2015,37,33,7,7,7,0,0,2
A Dananjaya ,Sri Lanka,2012,2024,33,33,7,7,7,0,0,1
I Danladi ,NGA,2019,2024,24,23,7,7,7,0,0,1
Dawlat Zadran ,Afghanistan,2012,2019,34,34,7,7,7,0,0,2
M Dixit ,LUX,2019,2023,28,28,7,7,7,0,0,2
BR Dunk ,Australia,2014,2017,5,5,7,5,1,4,2,3
Faisal Mubashir ,GER,2021,2024,23,23,7,7,7,0,0,2
Fawad Alam ,Pakistan,2007,2010,24,24,7,7,7,0,0,2
Fayaz Khan ,GER,2021,2024,13,13,7,7,7,0,0,3
J Fraser-McGurk ,Australia,2024,2024,7,7,7,7,7,0,0,3
Gagandeep Singh ,BUL,2023,2024,10,9,7,7,7,0,0,2
S Gajjar ,CZK-R,2020,2020,3,3,7,4,1,3,3,3
S Godara ,CAM,2023,2024,16,16,7,7,7,0,0,2
D Gumyusenge ,RWN,2024,2024,9,9,7,7,7,0,0,3
Harbhajan Singh ,India,2006,2016,28,27,7,7,7,0,0,2
Harmeet Singh ,United States of America,2024,2024,23,23,7,7,7,0,0,2
AW Hawkins-Kay ,JER,2019,2019,16,16,7,7,7,0,0,2
MJ Hay ,New Zealand,2024,2024,2,2,7,6,0,6,1,6
Hazratullah Zazai ,Afghanistan,2016,2024,44,44,7,7,7,0,0,1
DR Hooper ,GUE,2019,2023,24,24,7,7,7,0,0,2
AF Ifill ,CAY,2019,2023,19,19,7,7,7,0,0,1
Imran Tahir (SA/World),NA,2013,2019,38,38,7,7,7,0,0,2
Iqbal Hossain ,Aut,2021,2023,25,25,7,7,7,0,0,2
H Ivanov ,BUL,2019,2021,13,12,7,7,1,6,0,2
AJ Jabiri ,TAN,2022,2024,18,16,7,7,7,0,0,2
Kaleem Sana ,Canada,2022,2024,27,26,7,7,7,0,0,3
JH Kallis ,South Africa,2005,2012,25,25,7,7,7,0,0,2
A Kirschbaum ,Arg,2021,2024,15,15,7,7,7,0,0,2
EB Knowles ,CZK-R,2019,2021,14,14,7,7,4,3,0,4
ME Leoela ,LES,2021,2024,16,16,7,7,7,0,0,2
KK Lin Thu ,MYAN,2023,2024,19,19,7,7,7,0,0,2
MJ McClenaghan (ICC/NZ),NA,2012,2018,29,29,7,7,7,0,0,1
MW Machan ,Scotland,2013,2016,13,13,7,7,7,0,0,1
Mahmud Jasat ,PAN,2021,2023,14,14,7,7,7,0,0,2
T Manders ,BER,2021,2023,17,17,7,7,7,0,0,3
AD Mascarenhas ,England,2007,2009,14,14,7,7,7,0,0,2
BMAJ Mendis ,Sri Lanka,2011,2018,22,22,7,7,7,0,0,2
P Mishra ,BUL,2019,2024,50,48,7,7,7,0,0,2
J Miyagi ,UGA,2022,2024,26,25,7,7,7,0,0,1
Mohamed Arief ,MAS,2019,2023,20,19,7,7,7,0,0,2
PJ Moor ,Zimbabwe,2016,2019,21,21,7,7,5,2,0,2
J Mosca ,ITA,2022,2024,14,14,7,7,7,0,0,2
Mujeeb Ur Rahman ,Afghanistan,2018,2024,46,46,7,7,7,0,0,1
F Mutua ,Kenya,2023,2024,17,17,7,7,7,0,0,2
W Nalisa ,VAN,2019,2024,31,31,7,7,7,0,0,1
Namgay Thinley ,BHU,2022,2024,27,27,7,7,7,0,0,3
SP Narine ,West Indies,2012,2019,51,51,7,7,7,0,0,2
OB Nightingale ,GUE,2022,2024,24,24,7,7,7,0,0,2
N Nipiko ,VAN,2019,2024,39,39,7,7,7,0,0,2
I Ntirenganya ,RWN,2022,2024,32,32,7,7,7,0,0,1
AA Obanda ,Kenya,2007,2023,51,50,7,7,7,0,0,2
H Osinde ,Canada,2008,2013,11,11,7,7,7,0,0,2
A Parima ,COK,2022,2024,12,12,7,7,5,2,0,1
T Parima ,COK,2022,2024,12,12,7,7,7,0,0,2
WD Parnell ,South Africa,2009,2023,56,56,7,7,7,0,0,1
Parvindar Kumar ,KUW,2023,2024,11,11,7,7,7,0,0,2
A Paul ,EST,2022,2024,13,13,7,7,7,0,0,3
P Suanchuai ,THA,2020,2023,18,18,7,5,0,5,2,2
K Piet ,BOT,2022,2024,21,20,7,7,7,0,0,2
LE Plunkett ,England,2006,2019,22,22,7,7,7,0,0,1
M Podosky ,PHI,2022,2024,23,23,7,7,7,0,0,2
AR Puri ,SGP,2022,2024,29,29,7,7,7,0,0,2
C Roberts ,Fran,2024,2024,10,10,7,7,7,0,0,2
S Rossi ,Arg,2019,2023,10,10,7,7,7,0,0,2
GR Russ ,PHI,2019,2023,21,21,7,5,1,4,2,2
JD Ryder ,New Zealand,2008,2014,22,22,7,7,7,0,0,2
Sajid Cheema ,KSA,2019,2024,12,12,7,7,7,0,0,2
Sarfaraz Ali ,BHR,2019,2024,47,46,7,7,7,0,0,1
RR Sarwan ,West Indies,2007,2010,18,18,7,7,7,0,0,1
Shahid Arshad ,SVN,2022,2024,10,10,7,7,7,0,0,2
Shamim Hossain ,BAN,2021,2023,19,19,7,7,7,0,0,2
Sohaib Maqsood ,Pakistan,2013,2021,26,26,7,7,7,0,0,2
Sohail Tanvir ,Pakistan,2007,2017,57,57,7,7,7,0,0,1
H Ssenyondo ,UGA,2019,2024,80,78,7,7,7,0,0,2
ACF Stokes ,GUE,2019,2022,16,16,7,7,7,0,0,2
F Stoman ,PORT,2019,2024,21,21,7,6,5,1,1,2
Sulaiman Ali ,BUL,2020,2022,21,21,7,7,7,0,0,3
CR Suryawanshi ,SGP,2019,2023,5,5,7,6,3,3,1,2
MR Swart ,NED,2012,2016,26,26,7,7,7,0,0,1
SN Thakur ,India,2018,2022,25,24,7,7,7,0,0,1
S Thanikaithasan ,DEN,2021,2024,24,24,7,7,7,0,0,2
UNGB Thenannahelage ,CZK-R,2022,2022,9,9,7,3,0,3,4,2
AJ Turner ,Australia,2017,2023,19,19,7,7,7,0,0,1
Usman Khalid ,KSA,2021,2024,19,19,7,7,7,0,0,2
DV Varghese ,BUL,2020,2023,31,29,7,7,7,0,0,1
JM Vince ,England,2015,2022,17,17,7,7,7,0,0,2
Vishil Patel ,Kenya,2023,2024,16,16,7,7,7,0,0,2
PV Vuniwaqa ,Fiji,2022,2024,16,16,7,7,7,0,0,2
Waqas Ahmad ,MLT,2023,2023,15,15,7,7,7,0,0,2
BTJ Wheal ,Scotland,2016,2024,23,22,7,7,7,0,0,2
Yasir Ali ,BAN,2022,2023,11,11,7,7,7,0,0,2
KJ Young ,Blz,2019,2021,9,9,7,7,3,4,0,2
Yusuf Ebrahim ,PAN,2019,2023,13,13,7,7,7,0,0,2
Zain Ul Abidin ,KSA,2021,2024,31,31,7,7,7,0,0,2
Zain Ahmad ,Fran,2022,2024,17,17,7,7,7,0,0,2
Zawar Farid ,United Arab Emirates,2019,2023,18,18,7,7,7,0,0,1
Zhuang Zelin ,CHN,2023,2024,11,11,7,7,7,0,0,3
V Zimonjic ,SRB,2021,2024,28,27,7,7,7,0,0,1
Aayan Afzal Khan ,United Arab Emirates,2022,2024,36,36,6,6,6,0,0,2
Abdullah Mahmood ,DEN,2019,2024,14,14,6,6,6,0,0,1
Abdur Rehman ,Pakistan,2007,2013,8,8,6,6,6,0,0,2
KD Abeyrathna ,NOR,2021,2024,19,19,6,5,4,1,1,2
Abhijeet Ahuja ,HUN,2021,2023,19,19,6,6,6,0,0,2
VD Adewoye ,NGA,2019,2024,19,19,6,6,6,0,0,2
Adil Butt ,SWZ,2022,2024,16,15,6,6,6,0,0,1
Khalid Zahid ,SWE,2021,2024,20,20,6,6,6,0,0,1
PS Airee ,NEP,2015,2022,12,12,6,5,2,3,1,2
Akhil Anil ,TAN,2022,2024,27,26,6,6,6,0,0,1
J Alegra ,PHI,2022,2023,16,16,6,6,6,0,0,2
ASF Sirah ,PHI,2023,2024,14,14,6,6,6,0,0,2
Amjad Mahboob ,SGP,2019,2023,30,30,6,6,6,0,0,1
Areeb Quadir ,FIN,2019,2024,5,5,6,4,2,2,2,3
GD Arta ,INA,2022,2024,35,35,6,6,6,0,0,1
SK Atai ,Papau New Guinea,2019,2022,18,18,6,6,3,3,0,2
Atif Kamal ,LUX,2019,2022,15,15,6,6,6,0,0,1
Atif Rasheed ,FIN,2022,2024,16,16,6,6,6,0,0,2
R Baaleri ,GHA,2021,2024,23,23,6,6,6,0,0,1
JD Baker ,Samoa,2019,2022,10,10,6,6,6,0,0,3
V Baskaran ,SGP,2019,2022,33,33,6,6,6,0,0,1
RR Bastiansz ,MLT,2022,2023,5,5,6,6,6,0,0,2
GK Berg ,ITA,2021,2024,19,19,6,6,6,0,0,2
M Bhanuka ,Sri Lanka,2019,2021,5,5,6,6,0,6,0,2
Bilal Masud ,EST,2023,2024,13,13,6,6,6,0,0,2
DA Blignaut ,GER,2021,2023,29,29,6,6,6,0,0,2
NW Bracken ,Australia,2006,2009,19,19,6,6,6,0,0,1
DT Christian ,Australia,2010,2021,23,23,6,6,6,0,0,2
AG Cremer ,Zimbabwe,2008,2018,29,29,6,6,6,0,0,1
Delawar Khan ,DEN,2019,2024,24,22,6,6,6,0,0,2
STRA de Silva ,SEY,2022,2024,12,11,6,6,6,0,0,2
S di Bartolomeo ,ITA,2023,2024,7,7,6,6,6,0,0,2
BI Dilruksha ,SKOR,2024,2024,5,5,6,2,0,2,4,3
JEA Doctora ,PHI,2023,2023,10,10,6,6,6,0,0,2
BM Duckett ,England,2019,2023,12,12,6,6,6,0,0,2
JA Duffy ,New Zealand,2020,2024,15,14,6,6,6,0,0,2
N Dutta ,Canada,2019,2024,25,25,6,6,6,0,0,2
Fanyan Mughal ,MLT,2023,2024,24,24,6,6,6,0,0,1
KJ Ferrary ,GIBR,2021,2024,9,9,6,6,3,3,0,3
ST Finn ,England,2011,2015,21,21,6,6,6,0,0,1
JS Foster ,England,2009,2009,5,5,6,3,0,3,3,2
DM Gondaria ,Kenya,2013,2024,14,14,6,6,6,0,0,1
C Green ,Australia,2022,2024,13,13,6,6,6,0,0,2
J Grzinic ,CRT,2022,2024,7,7,6,5,1,4,1,2
Gurpratap Singh ,CYP,2021,2022,11,11,6,6,6,0,0,2
P Hatchman ,GIBR,2021,2023,13,13,6,6,6,0,0,2
R Hekure ,Papau New Guinea,2019,2023,24,24,6,6,6,0,0,2
MC Henriques ,Australia,2009,2021,24,24,6,6,6,0,0,1
S Hirugade ,Mex,2019,2024,14,14,6,6,6,0,0,1
GJ Hopkins ,New Zealand,2007,2010,10,10,6,4,2,2,2,2
Idrees Ul Haque ,SUI,2021,2024,10,10,6,6,2,4,0,3
Imran Haider ,ROM,2019,2021,4,4,6,4,0,4,2,3
Imran Ismail ,MOZ,2019,2019,7,6,6,6,1,5,0,2
Imran Khan ,PORT,2019,2024,10,10,6,6,6,0,0,1
Isa Zaroo ,BUL,2023,2024,11,10,6,6,6,0,0,2
Ishtiaq Ahmad ,KSA,2021,2024,31,31,6,6,6,0,0,1
B Ito-Davis ,Japan,2024,2024,10,10,6,6,6,0,0,3
MA Jones ,Scotland,2022,2024,11,10,6,6,6,0,0,2
Kaleemullah ,OMA,2017,2024,42,42,6,6,6,0,0,2
JP Kaltapau ,VAN,2022,2024,25,25,6,6,6,0,0,2
CJPF Kalugamage ,ITA,2022,2024,12,12,6,6,6,0,0,2
Kamran Ahmadzai ,Fran,2024,2024,9,9,6,6,6,0,0,2
J Kariko ,Papau New Guinea,2023,2024,19,19,6,6,6,0,0,1
Karim Sadiq ,Afghanistan,2010,2018,36,36,6,6,6,0,0,1
Khaibar Deldar ,HUN,2021,2022,15,14,6,6,6,0,0,1
SC Kuggeleijn ,New Zealand,2019,2021,18,18,6,6,6,0,0,2
P Kurup ,BHR,2021,2023,12,11,6,6,3,3,0,1
Lakshit Gupta ,CAM,2023,2024,24,23,6,6,6,0,0,1
B Lee ,Australia,2005,2012,25,25,6,6,6,0,0,3
GF Linde ,South Africa,2020,2021,14,14,6,6,6,0,0,3
BG Lister ,New Zealand,2023,2024,12,11,6,6,6,0,0,3
Lokesh Bam ,NEP,2022,2024,11,11,6,6,6,0,0,2
KDA Lukies ,PHI,2023,2024,21,21,6,6,6,0,0,2
P Malav ,LUX,2020,2024,28,28,6,6,6,0,0,1
HV Mandhyan ,HUN,2021,2024,21,20,6,6,6,0,0,1
R Mangal ,Fran,2022,2024,13,13,6,6,6,0,0,2
N Mapunda ,TAN,2021,2021,7,7,6,3,0,3,3,2
DS Maraiwai ,Fiji,2022,2023,9,9,6,6,6,0,0,2
E Mathew ,MLT,2023,2024,17,17,6,6,6,0,0,2
R Mazumder ,CYP,2021,2024,18,18,6,6,6,0,0,2
R Mbaiwa ,BOT,2022,2023,3,3,6,3,2,1,3,3
NSK Mehta ,Belg,2020,2021,9,9,6,6,6,0,0,2
BAW Mendis ,Sri Lanka,2008,2014,39,39,6,6,6,0,0,1
EJB Miles ,JER,2019,2023,33,33,6,6,6,0,0,2
Mohammad Ahnaff ,QAT,2023,2024,12,12,6,6,6,0,0,2
Mohammad Boota ,United Arab Emirates,2019,2022,19,19,6,4,1,3,2,2
Mohammad Kamran ,ESP,2022,2023,19,18,6,6,6,0,0,2
Mohammed Irshad ,QAT,2023,2024,10,10,6,6,6,0,0,2
Mohammed Siraj ,India,2017,2024,16,16,6,6,6,0,0,2
CH Morris ,South Africa,2012,2019,23,23,6,6,6,0,0,2
G Motie ,West Indies,2021,2024,26,25,6,6,6,0,0,2
Muhamad Syahadat ,MAS,2019,2024,31,30,6,6,6,0,0,2
Muhammad Moiz ,ROM,2024,2024,8,8,6,6,6,0,0,2
Muhammad Umar ,KUW,2024,2024,11,11,6,6,6,0,0,2
PWA Mulder ,South Africa,2021,2024,11,11,6,6,6,0,0,1
GBW Munaweera ,QAT,2019,2024,29,29,6,6,6,0,0,2
GC Murtaza ,CAM,2023,2024,24,23,6,6,6,0,0,1
TK Musakanda ,Zimbabwe,2018,2021,12,12,6,6,6,0,0,2
LA Musiani ,Arg,2019,2023,16,16,6,6,6,0,0,1
Y Naing Tun ,MYAN,2023,2024,9,9,6,5,0,5,1,2
Nasir Jamshed ,Pakistan,2012,2013,18,18,6,6,6,0,0,2
Nasum Ahmed ,BAN,2021,2023,35,34,6,6,6,0,0,2
Nazril Rahman ,MAS,2019,2022,13,13,6,6,6,0,0,2
Niv Nagavkar ,ISR,2022,2024,9,9,6,6,6,0,0,2
AR Nurse ,West Indies,2011,2019,13,13,6,6,6,0,0,2
SH Obed ,VAN,2019,2024,26,26,6,6,6,0,0,1
NM Odhiambo ,Kenya,2010,2024,64,62,6,6,6,0,0,2
Omar Rassol ,BUL,2021,2024,24,24,6,6,3,3,0,1
J Overton ,England,2024,2024,7,7,6,6,6,0,0,2
Paing Danu ,MYAN,2023,2024,19,19,6,6,5,1,0,3
R Parag ,India,2024,2024,9,9,6,6,6,0,0,3
NMS Param ,SGP,2019,2023,20,20,6,6,6,0,0,1
HH Patel ,MWest Indies,2019,2019,7,7,6,6,6,0,0,2
RB Patel ,UGA,2021,2024,42,41,6,6,6,0,0,1
BBJL Perera ,ITA,2019,2022,18,17,6,6,6,0,0,3
S Periyalwar ,ROM,2019,2024,34,34,6,6,5,1,0,1
D Pretorius ,South Africa,2017,2022,30,30,6,6,6,0,0,2
TJG Pringle ,NED,2022,2024,20,20,6,6,6,0,0,1
A Pusthay ,FIN,2019,2022,12,12,6,6,6,0,0,1
LN Rajbanshi ,NEP,2018,2024,23,23,6,6,6,0,0,2
Aminuddin Ramly ,MAS,2019,2021,23,22,6,6,6,0,0,2
H Rashid ,SWZ,2022,2023,15,14,6,6,6,0,0,2
D Ravu ,Papau New Guinea,2019,2022,24,24,6,6,6,0,0,1
Rehman Abdul ,ITA,2019,2019,7,6,6,6,6,0,0,2
RD Rickelton ,South Africa,2024,2024,12,12,6,6,3,3,0,2
Robert Raina ,THA,2020,2024,15,15,6,6,6,0,0,2
SE Rutherford ,West Indies,2018,2024,28,27,6,6,6,0,0,1
D Sabir ,BER,2021,2023,14,14,6,6,6,0,0,2
NM Salonen ,FIN,2024,2024,8,8,6,6,6,0,0,2
PADLR Sandakan ,Sri Lanka,2017,2021,20,20,6,6,6,0,0,2
AS Samra ,PHI,2023,2024,15,15,6,6,6,0,0,1
Sathya Narayanan ,SUI,2022,2022,5,5,6,6,0,6,0,4
Shafraz Jaleel ,MDV,2019,2019,4,4,6,4,0,4,2,3
Shahid Mahmood ,BHR,2022,2022,13,13,6,6,6,0,0,2
RR Sharan ,CAM,2023,2024,22,21,6,6,5,1,0,2
Sharjeel Khan ,Pakistan,2013,2021,21,21,6,6,6,0,0,2
A Shukla ,Hong Kong,2022,2024,38,37,6,6,6,0,0,2
TAM Siriwardana ,Sri Lanka,2015,2017,22,22,6,6,6,0,0,2
Sohail Ahmed ,BHR,2022,2024,33,32,6,6,6,0,0,1
DC Stovell ,BER,2019,2021,12,12,6,6,6,0,0,1
F Suluoto ,Samoa,2022,2024,12,12,6,6,5,1,0,1
PR Surve ,INA,2022,2024,29,29,6,6,6,0,0,1
Surya Anand ,DEN,2021,2024,28,28,6,6,6,0,0,1
Taranjit Singh ,CYP,2024,2024,9,9,6,6,6,0,0,3
GT Taylor ,Bhm,2021,2023,15,15,6,6,5,1,0,2
I Tchakou ,CAM,2021,2024,22,22,6,6,6,0,0,2
NK Tiwari ,CYP,2021,2024,17,17,6,6,6,0,0,2
RJW Topley ,England,2015,2024,35,35,6,6,6,0,0,2
Towhid Hridoy ,BAN,2023,2024,32,32,6,6,6,0,0,1
J Trembeath-Moro ,ESP,2022,2022,8,8,6,6,6,0,0,4
Usman Najeeb ,KSA,2022,2024,23,23,6,6,6,0,0,1
P Utseya ,Zimbabwe,2006,2015,35,35,6,6,6,0,0,1
J van Heerden ,GER,2022,2023,10,10,6,6,6,0,0,2
MN van Wyk ,South Africa,2007,2015,8,8,6,5,2,3,1,1
HGV Vare ,Papau New Guinea,2022,2024,13,13,6,6,1,5,0,1
JNT Vare ,Papau New Guinea,2015,2017,8,8,6,4,0,4,2,3
Wahab Riaz ,Pakistan,2008,2020,36,36,6,6,6,0,0,1
Walid Ghauri ,NOR,2019,2024,14,14,6,6,6,0,0,1
DF Watts ,Scotland,2007,2012,11,10,6,6,6,0,0,3
B Yadav ,NEP,2022,2024,19,19,6,6,6,0,0,2
WA Young ,New Zealand,2021,2024,20,19,6,6,6,0,0,1
Zahir Mohammed ,HUN,2021,2023,19,19,6,6,6,0,0,1
C Zavoiu ,ROM,2019,2023,21,21,6,6,6,0,0,1
Mohammad Aadil Alam ,NEP,2022,2022,8,8,5,5,5,0,0,2
Abdul Majid ,BHR,2023,2024,25,25,5,5,5,0,0,1
Adnan Ilyas ,OMA,2015,2016,12,11,5,5,5,0,0,3
Adnan Mirza ,QAT,2023,2024,14,14,5,5,5,0,0,1
KK Ahuja ,Mex,2019,2024,12,12,5,2,1,1,3,2
CM Akachukwu ,NGA,2019,2021,15,15,5,5,5,0,0,2
Ali Saleem ,NOR,2022,2024,21,21,5,5,5,0,0,2
Amandeep Singh ,PORT,2021,2024,17,17,5,5,5,0,0,2
Anamul Haque ,BAN,2012,2022,20,18,5,4,2,2,1,2
Anas Khan ,Hong Kong,2014,2024,22,22,5,5,5,0,0,2
Andre Jarju ,GMB,2022,2024,11,11,5,5,5,0,0,2
Anoop Orsu ,LUX,2022,2024,19,19,5,5,5,0,0,1
Anwar Ali ,Pakistan,2008,2016,16,16,5,5,5,0,0,2
JC Archer ,England,2019,2024,29,29,5,5,5,0,0,2
Ariful Haque ,BAN,2018,2018,9,9,5,5,5,0,0,1
Aritra Dutta ,SGP,2019,2024,25,25,5,5,5,0,0,2
Aryan Lakra ,United Arab Emirates,2022,2024,10,10,5,5,5,0,0,2
Asad Mohammad ,GER,2019,2021,11,11,5,5,5,0,0,1
Ashwin Vinod ,SUI,2021,2024,20,20,5,5,5,0,0,2
Ateeq Iqbal ,Hong Kong,2022,2024,22,21,5,5,5,0,0,1
Azam Khan ,Pakistan,2021,2024,14,14,5,5,1,4,0,1
Aziz Mohammad ,Belg,2019,2024,19,19,5,5,5,0,0,1
GG Banner ,Blz,2019,2021,9,9,5,5,5,0,0,2
DM Bravo ,West Indies,2010,2022,26,26,5,5,5,0,0,2
S Browne ,LUX,2020,2020,4,4,5,5,5,0,0,2
Z Burgess ,BER,2021,2023,13,13,5,5,5,0,0,2
PKD Chase ,Ireland,2018,2019,12,12,5,5,5,0,0,2
MPS Cheema ,Aut,2022,2023,19,19,5,4,1,3,1,1
LA Collado ,GIBR,2019,2021,9,9,5,2,0,2,3,2
S Conteh ,Sri LankaE,2021,2024,29,29,5,5,5,0,0,2
BCJ Cutting (AUS/World),NA,2013,2017,7,7,5,5,5,0,0,3
MD Dai ,Papau New Guinea,2015,2017,9,9,5,5,5,0,0,2
R Drake ,Japan,2022,2024,14,14,5,5,5,0,0,2
K Dasan ,BUL,2019,2020,10,9,5,3,1,2,2,2
Devender Singh ,GHA,2021,2024,21,21,5,5,5,0,0,2
A Dizija ,SRB,2022,2024,25,24,5,5,5,0,0,1
FH Edwards ,West Indies,2007,2021,26,26,5,5,5,0,0,1
SA Engelbrecht ,NED,2024,2024,12,12,5,5,5,0,0,2
Fahad Ali ,BRA,2019,2019,3,3,5,4,2,2,1,3
Faisal Javed ,QAT,2019,2019,15,15,5,5,5,0,0,1
Fareed Ahmad ,Afghanistan,2016,2024,30,29,5,5,5,0,0,1
Fazalhaq Farooqi ,Afghanistan,2021,2024,42,42,5,5,5,0,0,1
A Ferguson ,Arg,2019,2023,19,19,5,5,4,1,0,1
K Fletcher ,SUI,2022,2024,16,16,5,5,5,0,0,1
A Flintoff ,England,2005,2007,7,7,5,5,5,0,0,2
BC Fortuin ,South Africa,2019,2024,25,25,5,5,5,0,0,2
TS Fray ,BER,2019,2023,21,21,5,5,5,0,0,2
AA Gajic ,SRB,2022,2024,18,17,5,5,5,0,0,2
Gaurav Mishra ,ROM,2022,2023,12,12,5,5,5,0,0,2
BD Glover ,NED,2019,2024,25,25,5,5,5,0,0,1
SP Gomes ,PORT,2022,2023,7,7,5,5,5,0,0,2
S Gooch ,EST,2024,2024,9,9,5,5,5,0,0,1
AGS Gous ,United States of America,2024,2024,23,23,5,4,1,3,1,2
DAS Gunaratne ,Sri Lanka,2016,2017,12,12,5,5,5,0,0,2
M Gunasekara ,CYP,2024,2024,11,11,5,5,5,0,0,2
S Hallett ,Peru,2019,2019,4,4,5,4,0,4,1,3
Hamza Tahir ,Scotland,2018,2024,17,17,5,5,5,0,0,1
Haroon Arshad ,Hong Kong,2019,2024,36,36,5,5,5,0,0,2
Hasan Mahmud ,BAN,2020,2024,18,18,5,5,5,0,0,2
N Henderson ,SUI,2021,2022,5,5,5,5,2,3,0,2
P Heron ,CAY,2022,2023,11,11,5,5,5,0,0,2
BJ Hodge ,Australia,2007,2014,15,15,5,5,5,0,0,1
A Husain ,Arg,2019,2024,16,16,5,5,5,0,0,1
Hussain Talat ,Pakistan,2018,2021,18,18,5,5,5,0,0,3
Ilyas Ataullah ,TKY,2022,2024,12,11,5,5,5,0,0,2
Imal Zuwak ,SWE,2021,2024,16,16,5,5,5,0,0,2
WG Jacks ,England,2022,2024,23,23,5,5,5,0,0,1
Jagjit Singh ,Peru,2019,2019,4,4,5,5,5,0,0,3
D Jansen ,IOM,2021,2023,12,12,5,5,5,0,0,1
KM Jarvis ,Zimbabwe,2011,2019,22,22,5,5,5,0,0,1
CK Jasmat ,Samoa,2022,2024,12,12,5,5,5,0,0,3
Jaspreet Singh ,ITA,2019,2024,21,20,5,5,5,0,0,1
MG Johnson ,Australia,2007,2013,30,30,5,5,5,0,0,1
MO Jones ,BER,2019,2023,18,18,5,5,5,0,0,2
EC Joyce (ENG/IRE),NA,2006,2014,18,17,5,5,5,0,0,2
Junaid Sheikh ,NOR,2019,2019,5,5,5,5,5,0,0,2
SI Kamea ,Papau New Guinea,2022,2024,19,19,5,5,5,0,0,1
A Kansonkho ,MWest Indies,2021,2023,7,7,5,5,5,0,0,3
M Kasselman ,BOT,2023,2024,6,6,5,5,5,0,0,3
CA Keita ,Mali,2022,2024,15,14,5,5,5,0,0,3
AL Kerai ,Sri LankaE,2021,2021,9,9,5,5,5,0,0,3
SP Khakurel ,NEP,2014,2015,8,8,5,2,0,2,3,2
UT Khawaja ,Australia,2016,2016,9,9,5,5,5,0,0,1
Khurram Nawaz ,OMA,2017,2022,24,24,5,5,5,0,0,1
Khushdil Shah ,Pakistan,2019,2023,27,27,5,5,5,0,0,1
RK Kiseto ,TAN,2021,2022,13,13,5,5,5,0,0,2
MB Kruger ,Namibia,2024,2024,17,16,5,5,5,0,0,2
E Kubwimana ,RWN,2022,2024,27,27,5,5,5,0,0,1
HG Kuhn ,South Africa,2009,2017,7,7,5,5,1,4,0,3
R Kumar ,ROM,2019,2024,15,15,5,5,5,0,0,2
S Kushretha ,LUX,2020,2024,13,13,5,5,5,0,0,1
AV Lalcheta ,OMA,2015,2019,17,16,5,5,5,0,0,2
L Lamin ,Sri LankaE,2021,2024,33,33,5,5,5,0,0,1
JAD Lawrenson ,JER,2023,2024,12,12,5,5,5,0,0,2
Lucky Ali ,DEN,2019,2023,21,21,5,5,5,0,0,2
Maaz Khan ,LES,2021,2024,23,23,5,5,5,0,0,1
A Maheshwari ,CRT,2022,2024,12,12,5,5,5,0,0,2
XM Marshall (USA/WI),NA,2008,2021,20,20,5,5,5,0,0,1
JC Martin ,GUE,2020,2022,4,4,5,1,0,1,4,3
T Maruma ,Zimbabwe,2008,2019,13,13,5,5,5,0,0,1
B Masauko ,MWest Indies,2022,2023,11,11,5,5,5,0,0,2
S Matsikenyeri ,Zimbabwe,2006,2012,10,10,5,5,5,0,0,2
H McAleer ,IOM,2024,2024,5,5,5,4,0,4,1,2
A Mene-Ejegi ,SRB,2022,2024,13,13,5,5,5,0,0,2
Mirwais Ashraf ,Afghanistan,2010,2016,25,25,5,5,5,0,0,1
Mohammad Haris ,Pakistan,2022,2023,9,9,5,5,4,1,0,2
Mohamed Shafeeq ,KUW,2022,2024,32,32,5,5,5,0,0,1
M Morkel (SA/World),NA,2007,2017,44,44,5,5,5,0,0,1
CB Mpofu ,Zimbabwe,2008,2020,32,32,5,5,5,0,0,2
Muhammad Jabir ,QAT,2023,2024,14,14,5,5,5,0,0,2
Muhammad Murad ,QAT,2021,2023,15,15,5,5,5,0,0,2
Muhammad Safdar ,BHR,2022,2022,3,3,5,4,0,4,1,3
D Muhumuza ,UGA,2019,2022,32,31,5,5,5,0,0,1
A Mundra ,SWE,2024,2024,4,4,5,4,0,4,1,3
T Munyonga ,Zimbabwe,2019,2024,15,15,5,5,5,0,0,2
A Nao ,Papau New Guinea,2017,2024,18,18,5,5,5,0,0,1
R Nath ,TKY,2022,2024,12,11,5,5,0,5,0,2
AA Navicha ,MOZ,2021,2024,28,28,5,5,5,0,0,1
Nazmus Sakib ,MAS,2024,2024,4,4,5,2,0,2,3,3
OE Newey ,GUE,2019,2022,10,10,5,4,0,4,1,2
RJ Nicol ,New Zealand,2010,2013,21,21,5,5,5,0,0,2
Noorkhan Ahmedi ,SUI,2021,2024,10,10,5,5,5,0,0,2
Noor Ahmad ,Afghanistan,2022,2024,14,14,5,5,5,0,0,2
JJ Nyambo ,TAN,2022,2024,13,13,5,5,5,0,0,2
TM Odoyo ,Kenya,2007,2013,11,11,5,5,5,0,0,2
Osama Mahmood ,SUI,2021,2024,15,15,5,5,5,0,0,1
A Otwani ,UGA,2019,2022,17,16,5,5,3,2,0,1
DR Patankar ,MLT,2023,2024,17,17,5,5,4,1,0,1
HV Patel ,India,2021,2023,25,24,5,5,5,0,0,2
MV Pavlovic ,SRB,2022,2024,16,15,5,5,5,0,0,2
Raaz Mohammad ,FIN,2021,2024,21,21,5,5,5,0,0,1
A Randhawa ,Aut,2022,2024,21,21,5,5,5,0,0,1
V Ravindran ,HUN,2023,2024,9,9,5,4,4,0,1,2
Saeed Ahmed ,SWE,2023,2024,9,9,5,5,5,0,0,2
Bilal Safdar ,NOR,2021,2022,9,9,5,5,5,0,0,2
Sahibzada Farhan ,Pakistan,2018,2024,8,8,5,5,5,0,0,2
Salman Nazar ,Canada,2021,2022,8,8,5,5,5,0,0,3
Sarawut Maliwan ,THA,2023,2024,24,24,5,5,5,0,0,1
Saud Islam ,UGA,2021,2021,20,19,5,5,5,0,0,2
E Schiferli ,NED,2008,2010,7,6,5,5,5,0,0,1
K Senamontree ,THA,2019,2024,16,16,5,5,5,0,0,2
Shafiq Sharif ,MAS,2019,2021,13,12,5,2,0,2,3,2
OA Shah ,England,2007,2009,17,17,5,5,5,0,0,2
M Shahbaz Butt ,NOR,2022,2023,10,10,5,5,5,0,0,2
A Shahi ,CYP,2024,2024,9,9,5,5,5,0,0,2
Shahzeb Choudhry ,SWE,2023,2023,5,5,5,5,5,0,0,2
J Shaju ,MLT,2021,2024,23,23,5,5,5,0,0,1
Shan Masood ,Pakistan,2022,2022,19,19,5,5,5,0,0,2
Shapoor Zadran ,Afghanistan,2010,2020,36,36,5,5,5,0,0,1
Sheikh Rasik ,HUN,2023,2024,6,6,5,5,5,0,0,2
Shubman Gill ,India,2023,2024,21,21,5,5,5,0,0,1
RJ Sidebottom ,England,2007,2010,18,18,5,5,5,0,0,2
LPC Silva ,Sri Lanka,2006,2011,16,16,5,5,5,0,0,1
G Singh ,United States of America,2021,2024,13,13,5,5,5,0,0,2
CB Sole ,Scotland,2017,2024,17,16,5,5,5,0,0,3
TB Sole ,Scotland,2019,2019,9,9,5,5,5,0,0,1
E Solomon ,ISR,2022,2024,9,9,5,5,5,0,0,1
CA Soper ,Papau New Guinea,2015,2024,31,31,5,5,5,0,0,1
G Stewart ,ITA,2021,2023,14,14,5,5,5,0,0,2
GP Swann ,England,2008,2012,39,39,5,5,5,0,0,1
S Tabuisulu ,Fiji,2023,2024,10,10,5,5,5,0,0,3
Talha Khan ,GER,2019,2023,28,28,5,5,5,0,0,2
Tarun Sharma ,SVN,2024,2024,5,5,5,5,5,0,0,3
TG Thamae ,LES,2021,2024,16,16,5,5,5,0,0,1
SO Tikolo ,Kenya,2007,2013,15,15,5,5,5,0,0,2
C Udekwe ,NGA,2022,2024,23,22,5,5,5,0,0,1
Usman Arif ,NOR,2021,2022,9,9,5,5,5,0,0,2
Usman Qadir ,Pakistan,2020,2023,25,25,5,5,5,0,0,1
T Vanuarua ,COK,2022,2022,6,6,5,5,5,0,0,2
Vichanath Singh ,THA,2019,2023,15,15,5,5,5,0,0,2
V Vijh ,LUX,2019,2024,42,42,5,5,5,0,0,1
C Viljoen ,Namibia,2019,2019,12,12,5,5,5,0,0,1
TP Visee ,NED,2015,2021,31,30,5,5,5,0,0,1
Walter Behr ,GER,2022,2022,8,8,5,5,5,0,0,2
B White ,Ireland,2021,2024,33,33,5,5,5,0,0,1
MA Wood ,England,2015,2024,34,34,5,5,5,0,0,2
W Wotu ,VAN,2022,2024,18,18,5,5,5,0,0,2
Yusuf Bhoola ,PAN,2021,2021,5,5,5,5,5,0,0,2
ZM Tribe ,JER,2021,2024,21,21,5,5,5,0,0,2
Zuhaib Zubair ,United Arab Emirates,2024,2024,6,6,5,5,5,0,0,2
NP Kenjige ,United States of America,2024,2024,21,21,4,4,4,0,0,1
Aadil Bhaiyat ,SWZ,2024,2024,5,5,4,4,2,2,0,2
Abbas Afridi ,Pakistan,2024,2024,13,13,4,4,4,0,0,2
Abdul Rahman ,SGP,2022,2023,10,10,4,4,4,0,0,1
Abdul Wahid ,KSA,2019,2024,15,15,4,4,4,0,0,1
N Acawei ,Fiji,2022,2023,10,10,4,4,4,0,0,2
Aftab Ahmed ,BAN,2006,2010,11,11,4,4,4,0,0,2
N Ahir ,PAN,2021,2023,11,11,4,4,4,0,0,1
Ahmadullah Shinwari ,NOR,2021,2024,11,11,4,4,4,0,0,3
KK Ahmed ,India,2018,2024,18,18,4,4,4,0,0,1
Ahmed Hassan ,MDV,2019,2022,21,21,4,4,4,0,0,2
Alam Nakash ,SKOR,2022,2024,10,10,4,4,4,0,0,1
J Albin ,BUL,2021,2022,25,25,4,4,3,1,0,1
Altaf Gill ,SKOR,2024,2024,3,3,4,4,4,0,0,2
Al-Amin Hossain ,BAN,2013,2020,31,29,4,4,4,0,0,1
Amjad Javed ,United Arab Emirates,2014,2017,22,22,4,4,4,0,0,1
Aqeel Wahid ,MAS,2024,2024,15,15,4,4,4,0,0,1
P Arrighi ,Arg,2019,2023,8,8,4,4,4,0,0,2
Arsalan Arif ,Aut,2019,2024,4,4,4,3,3,0,1,3
Arsalan Ahmed ,GRC,2019,2021,7,7,4,4,4,0,0,2
Asad Ali Rehemtulla ,BUL,2020,2022,16,16,4,4,4,0,0,1
Imran Asif ,Aut,2021,2024,11,11,4,4,4,0,0,1
Aslam Khan ,MAS,2022,2024,9,9,4,4,4,0,0,2
Aslam Mohammad ,GRC,2019,2024,14,14,4,4,4,0,0,2
Awais Malik ,QAT,2019,2020,18,18,4,4,4,0,0,2
Azyan Farhath ,MDV,2019,2024,35,35,4,4,4,0,0,1
C Bah ,Sri LankaE,2021,2024,25,25,4,4,4,0,0,1
MM Baig ,QAT,2023,2024,11,11,4,4,4,0,0,2
B Banerjee ,Mex,2019,2019,6,6,4,4,1,3,0,1
RR Behera ,United States of America,2021,2021,2,2,4,4,4,0,0,2
IR Bell ,England,2006,2014,8,8,4,4,4,0,0,1
MP Biddappa ,PHI,2019,2022,7,7,4,3,0,3,1,2
Bilal Zalmai ,Aut,2019,2024,14,14,4,4,4,0,0,2
C Bogdanos ,GRC,2022,2024,6,6,4,4,4,0,0,2
PRP Boissevain ,NED,2019,2021,7,7,4,4,4,0,0,2
SE Bond ,New Zealand,2005,2010,20,20,4,4,4,0,0,1
CJ Bowes ,New Zealand,2023,2023,11,10,4,4,4,0,0,1
MP Breetzke ,South Africa,2023,2024,8,8,4,4,4,0,0,1
J Broad ,GER,2022,2022,9,9,4,4,4,0,0,1
NT Broom ,New Zealand,2009,2017,11,11,4,4,4,0,0,1
DE Budge ,Scotland,2018,2021,8,8,4,4,4,0,0,1
Bukhar Illikkal ,QAT,2023,2023,11,11,4,4,4,0,0,1
JA Burns ,ITA,2024,2024,5,5,4,4,4,0,0,2
A Bushell ,GUE,2023,2023,3,3,4,3,0,3,1,3
M Chadha ,CAM,2023,2024,6,6,4,3,0,3,1,3
N Chejay ,BHU,2019,2024,11,11,4,3,3,0,1,1
Chen Zhuo Yue ,CHN,2023,2024,11,11,4,4,4,0,0,1
J Chialoufas ,CYP,2024,2024,10,10,4,4,4,0,0,2
VB Chikkannaiah ,GER,2019,2023,27,27,4,4,4,0,0,1
JW Chilia ,VAN,2019,2019,14,14,4,4,4,0,0,2
K Christie ,Hong Kong,2019,2019,11,11,4,4,4,0,0,1
SR Clark ,Australia,2006,2007,9,9,4,4,4,0,0,1
SJ Cotter ,Samoa,2019,2024,16,16,4,4,4,0,0,2
DDP D'Silva ,United Arab Emirates,2019,2019,10,10,4,4,4,0,0,1
DAP Darrell ,BER,2019,2019,11,11,4,4,4,0,0,2
TN de Grooth ,NED,2008,2013,15,14,4,4,4,0,0,2
JL Denly ,England,2009,2020,13,13,4,4,4,0,0,1
R Dhakal ,NEP,2024,2024,6,6,4,4,4,0,0,1
Dhananjay Rao ,Hong Kong,2024,2024,8,8,4,4,4,0,0,1
S Dhaniram ,Canada,2008,2010,11,11,4,4,4,0,0,2
RM Dorji ,BHU,2019,2024,24,24,4,4,4,0,0,1
Elias Sunny ,BAN,2012,2012,7,7,4,4,4,0,0,3
GD Elliott (NZ/World),NA,2009,2017,17,17,4,4,4,0,0,2
Fahad Tariq ,United Arab Emirates,2016,2016,6,6,4,4,4,0,0,3
Faheem Nazir ,SUI,2022,2024,18,18,4,4,4,0,0,2
Farhad Reza ,BAN,2006,2014,13,13,4,4,4,0,0,1
Festus Benn ,Bhm,2022,2023,9,9,4,4,4,0,0,2
B Fitchet ,GUE,2023,2024,14,14,4,4,4,0,0,1
MW Forde ,West Indies,2023,2024,6,6,4,4,4,0,0,1
O Fournier ,CRC,2019,2019,2,2,4,4,4,0,0,2
PG Fulton ,New Zealand,2006,2012,12,12,4,4,4,0,0,1
R Gaznavi ,SGP,2019,2024,24,24,4,4,4,0,0,1
S Ghimire ,PORT,2023,2024,12,12,4,3,1,2,1,1
D Gim ,NGA,2019,2021,17,17,4,4,4,0,0,2
RJ Gleeson ,England,2022,2022,6,6,4,4,4,0,0,1
G Goudie ,Scotland,2010,2013,9,9,4,4,4,0,0,1
A Govorko ,CRT,2024,2024,4,4,4,4,0,4,0,2
TGJ Gruijters ,NED,2012,2013,8,8,4,4,4,0,0,2
K Gupta ,Chile,2019,2019,4,4,4,3,0,3,1,3
OJ Hairs ,Scotland,2019,2024,27,27,4,4,4,0,0,1
RM Haq ,Scotland,2007,2013,21,20,4,4,4,0,0,2
AM Hardie ,Australia,2023,2024,13,13,4,4,4,0,0,1
BE Hendricks ,South Africa,2014,2021,19,19,4,4,4,0,0,2
L Hermida ,Mex,2019,2024,9,9,4,4,4,0,0,1
K Hinds ,Bhm,2021,2023,10,10,4,4,4,0,0,1
V Hristov ,BUL,2021,2023,4,4,4,4,1,3,0,3
Huang Junjie ,CHN,2024,2024,7,7,4,4,0,4,0,2
Huzaifa Mohammed ,PHI,2022,2024,24,24,4,4,4,0,0,1
DP Hyatt ,West Indies,2011,2012,5,5,4,4,4,0,0,1
Ibrahim Rahimi ,NOR,2022,2024,5,5,4,4,4,0,0,3
Ijaz Hussain ,ROM,2019,2024,27,27,4,4,4,0,0,1
Imran Khan ,BHR,2022,2024,17,16,4,4,4,0,0,1
Imrul Kayes ,BAN,2010,2017,14,14,4,4,4,0,0,1
VR Iyer ,India,2021,2022,9,9,4,4,4,0,0,2
Jai Sinh ,SUI,2022,2024,8,8,4,4,4,0,0,2
Y Jalloh ,Sri LankaE,2023,2024,7,7,4,4,4,0,0,2
KA Jamieson ,New Zealand,2020,2023,13,13,4,4,4,0,0,2
Javed Maroofkhail ,NOR,2019,2024,14,14,4,4,4,0,0,1
GSNFG Jayasuriya ,Sri Lanka,2015,2020,18,18,4,4,4,0,0,1
ST Jayasuriya ,Sri Lanka,2006,2011,31,31,4,4,4,0,0,1
M Jele (SWA/SWZ),NA,2021,2024,26,25,4,4,4,0,0,1
JM Joao ,MOZ,2022,2024,13,13,4,4,4,0,0,1
M Jobarteh ,GMB,2022,2024,12,12,4,4,4,0,0,2
J Jojo ,DEN,2019,2022,13,11,4,4,4,0,0,2
Joshua Asia ,NGA,2022,2024,15,15,4,4,4,0,0,1
Jubaid Ahamed ,Fran,2021,2022,9,9,4,4,4,0,0,1
L Kamarlekar ,ISR,2022,2022,1,1,4,4,0,4,0,4
SHT Kandamby ,Sri Lanka,2008,2011,5,5,4,4,4,0,0,2
Karanbir Singh ,Aut,2024,2024,9,9,4,4,4,0,0,2
Kashif Daud ,United Arab Emirates,2021,2022,16,16,4,4,4,0,0,2
S Kaveri ,Mex,2019,2024,16,16,4,4,4,0,0,2
AN Kervezee ,NED,2009,2012,10,10,4,4,4,0,0,2
Khalid Latif ,Pakistan,2008,2016,13,13,4,4,4,0,0,1
P Khari ,CZK-R,2023,2023,3,3,4,4,0,4,0,3
A Kheterpal ,HUN,2021,2023,18,18,4,4,4,0,0,1
Khin Aye ,MYAN,2023,2024,19,19,4,4,4,0,0,1
B Khumalo ,BOT,2019,2024,17,17,4,4,4,0,0,1
R Klein ,NED,2022,2024,6,6,4,4,4,0,0,3
N Krishna ,SEY,2021,2024,18,17,4,4,4,0,0,1
Kuldeep Lal ,ESP,2019,2021,11,11,4,4,4,0,0,2
C Kyewuta ,UGA,2021,2024,29,29,4,4,4,0,0,2
CJ Langford ,IOM,2020,2024,17,16,4,4,4,0,0,1
RE Levi ,South Africa,2012,2012,13,13,4,4,4,0,0,1
M Levitt ,NED,2024,2024,18,18,4,4,4,0,0,2
O Lutbayar ,MNG,2023,2024,14,14,4,4,4,0,0,2
OC McCoy ,West Indies,2019,2024,39,39,4,4,4,0,0,1
N Madziva ,Zimbabwe,2015,2019,15,15,4,4,4,0,0,1
WL Madsen ,ITA,2023,2023,4,4,4,4,4,0,0,2
D Madushanka ,Sri Lanka,2022,2024,15,15,4,4,4,0,0,1
G Manan ,ROM,2019,2023,15,15,4,4,4,0,0,1
MSS Mandy ,Chile,2019,2019,4,4,4,4,4,0,0,1
P Manning ,CAY,2019,2023,13,13,4,4,4,0,0,2
A Manousis ,GRC,2019,2022,11,11,4,2,2,0,2,1
I Mansaray ,Sri LankaE,2021,2021,4,4,4,4,0,4,0,2
S Mathur ,Hong Kong,2023,2023,7,7,4,4,3,1,0,2
ZE Matsinhe ,MOZ,2019,2022,22,21,4,4,4,0,0,1
S Mba ,NGA,2021,2021,8,8,4,4,4,0,0,2
A McAuley ,IOM,2020,2024,23,22,4,4,4,0,0,1
Md Nurul Huda ,FIN,2019,2019,5,5,4,4,4,0,0,2
DA Mehta ,TAN,2022,2023,4,3,4,4,4,0,0,2
KP Meiyappan ,United Arab Emirates,2021,2023,15,15,4,4,4,0,0,2
Milind Kumar ,United States of America,2024,2024,12,12,4,4,4,0,0,2
K Mirpuri ,GIBR,2023,2024,22,22,4,4,4,0,0,1
Mohammad Ashraful ,BAN,2007,2013,23,23,4,4,4,0,0,1
Mohammad Atif ,ESP,2022,2024,6,6,4,4,4,0,0,2
Mohammad Ghazanfar ,Hong Kong,2019,2024,29,29,4,4,4,0,0,1
Mohammad Mithun ,BAN,2014,2021,17,15,4,4,4,0,0,2
Mohammad Naveed ,United Arab Emirates,2015,2019,31,31,4,4,4,0,0,1
SA Mohandas ,HUN,2021,2024,22,21,4,4,4,0,0,1
KV Morea ,Papau New Guinea,2021,2024,21,21,4,4,4,0,0,2
DR Mousley ,England,2024,2024,4,4,4,4,4,0,0,2
Muhammad Awais ,GRC,2019,2019,3,3,4,3,0,3,1,3
Muhammad Jawadullah ,United Arab Emirates,2023,2024,23,23,4,4,4,0,0,2
Muhammad Siddiqui ,SVN,2022,2024,9,9,4,4,4,0,0,1
GRD Munasinghe ,ITA,2019,2019,8,7,4,4,4,0,0,1
Musaddiq Ahmed ,GER,2024,2024,4,4,4,4,4,0,0,2
AK Muslar ,Blz,2019,2021,9,9,4,1,1,0,3,1
D Myers ,Zimbabwe,2021,2024,18,18,4,4,4,0,0,1
K Namchaikul ,THA,2022,2024,18,18,4,4,4,0,0,1
N Naranbaatar ,MNG,2023,2024,13,13,4,4,4,0,0,1
S Navaratne ,Japan,2022,2023,8,8,4,4,3,1,0,2
Nawaf Ahmed ,KUW,2019,2024,10,10,4,4,4,0,0,1
Nazwan Ismail ,MDV,2019,2024,14,14,4,4,4,0,0,1
A Ndlovu ,Zimbabwe,2019,2024,12,12,4,4,4,0,0,2
A Nehra ,India,2009,2017,27,27,4,4,4,0,0,1
A Neill ,Scotland,2019,2019,5,5,4,4,4,0,0,2
GE Ngegba ,Sri LankaE,2022,2024,24,24,4,4,4,0,0,1
AT Nidamanuru ,NED,2022,2024,18,18,4,4,4,0,0,1
Nimish Lathief ,KUW,2023,2024,14,14,4,4,4,0,0,2
Noman Amjad ,Fran,2021,2024,23,23,4,4,4,0,0,1
Noor Ali Zadran ,Afghanistan,2010,2023,23,22,4,4,4,0,0,1
L Nyarko ,GHA,2024,2024,5,5,4,4,4,0,0,2
MMR Obili ,EST,2021,2022,12,12,4,4,4,0,0,2
VS Padhaal ,FIN,2019,2024,31,31,4,4,4,0,0,1
AE Paraam ,SGP,2019,2024,17,17,4,4,4,0,0,1
D Parashar ,United Arab Emirates,2023,2024,6,6,4,4,4,0,0,2
AJ Parmar ,NOR,2024,2024,8,8,4,4,4,0,0,1
IKA Pastika ,INA,2023,2023,3,3,4,4,4,0,0,2
JS Patel ,New Zealand,2005,2008,11,11,4,4,4,0,0,1
JE Pitcher ,BER,2019,2023,9,9,4,4,4,0,0,2
B Pondani ,MWest Indies,2021,2024,32,32,4,4,4,0,0,1
Pramod Madushan ,Sri Lanka,2022,2023,8,8,4,4,4,0,0,1
AR Prasad ,CAM,2023,2024,22,21,4,4,4,0,0,2
S Prasanna ,Sri Lanka,2013,2017,20,20,4,4,4,0,0,2
Pyae Phyo Wai ,MYAN,2023,2024,19,19,4,4,4,0,0,2
PA Raikes ,GIBR,2021,2024,15,15,4,4,4,0,0,2
Raja Adeel ,ESP,2019,2024,27,27,4,4,4,0,0,1
Raja Shoaib ,SKOR,2022,2024,10,10,4,3,0,3,1,3
S Ravikumar ,CRC,2019,2024,8,8,4,4,4,0,0,2
AT Rayudu ,India,2014,2016,6,6,4,4,4,0,0,2
B Regmi ,NEP,2014,2019,18,18,4,4,4,0,0,1
Rhys Burinaga ,PHI,2024,2024,7,7,4,4,4,0,0,2
MJG Rippon (NED/NZ),NA,2013,2022,19,18,4,4,4,0,0,1
CP Rizwan ,United Arab Emirates,2019,2023,18,18,4,4,4,0,0,1
Rizwan Haider ,MAS,2022,2024,31,30,4,4,4,0,0,2
T Rossi ,Arg,2021,2024,15,15,4,4,4,0,0,1
Salvin Stanly ,CAM,2023,2024,16,16,4,4,4,0,0,1
BA Sambo ,MOZ,2019,2023,5,5,4,4,0,4,0,2
DR Sams ,Australia,2020,2022,10,10,4,4,4,0,0,2
PR Santhanakrishnan ,Mex,2023,2024,9,9,4,2,1,1,2,2
Saqlain Haider ,United Arab Emirates,2016,2016,6,6,4,4,4,0,0,2
A Saud ,NEP,2022,2022,3,3,4,2,0,2,2,3
Saud Munir ,DEN,2022,2023,13,13,4,4,4,0,0,2
Sazib Bhuiyan ,CZK-R,2022,2024,20,20,4,4,4,0,0,1
R Sekaran ,EST,2024,2024,4,4,4,4,0,4,0,2
Shagharai Sefat ,Belg,2021,2023,10,10,4,4,4,0,0,2
Usman Shahid ,Fran,2021,2021,4,4,4,4,4,0,0,2
Shahzaib Jamil ,QAT,2024,2024,6,6,4,3,0,3,1,2
Sharafuddin Ashraf ,Afghanistan,2015,2024,19,18,4,4,4,0,0,2
I Sharma ,India,2008,2013,14,14,4,4,4,0,0,1
JM Sharma ,India,2023,2024,9,9,4,3,0,3,1,1
D Sheeli ,KUW,2019,2023,7,7,4,4,4,0,0,3
Sikander Zulfiqar ,NED,2016,2019,11,11,4,4,4,0,0,2
Simandeep Singh ,Hong Kong,2019,2019,7,7,4,4,4,0,0,2
RM Siri ,Arg,2019,2021,10,10,4,4,4,0,0,2
LSP Siriwardene ,ISR,2024,2024,4,4,4,2,0,2,2,3
Sohail Ahmad ,CRT,2022,2023,9,8,4,4,4,0,0,2
MJ Swepson ,Australia,2018,2022,8,8,4,4,4,0,0,2
Syed Maisam Ali ,PORT,2022,2024,10,10,4,4,4,0,0,2
ES Szwarczynski ,NED,2008,2013,14,13,4,4,4,0,0,2
Tanwir Afzal ,Hong Kong,2014,2016,21,21,4,4,4,0,0,1
Tanzeel Sheikh ,Kenya,2022,2024,18,17,4,4,4,0,0,2
Tanzid Hasan ,BAN,2024,2024,15,15,4,4,4,0,0,1
T Taylor ,CAY,2019,2023,15,15,4,4,4,0,0,1
RN ten Doeschate ,NED,2008,2021,24,23,4,4,4,0,0,1
DT Tiripano ,Zimbabwe,2016,2022,23,23,4,4,4,0,0,1
S Tosic ,SRB,2021,2024,22,21,4,4,4,0,0,2
BN Toube ,CAM,2021,2024,22,22,4,4,4,0,0,2
A Turkmen ,TKY,2022,2024,12,11,4,4,4,0,0,1
I Udana ,Sri Lanka,2009,2021,35,34,4,4,4,0,0,2
Umar Amin ,Pakistan,2013,2018,14,14,4,4,4,0,0,1
DLS van Bunge ,NED,2008,2013,14,13,4,4,4,0,0,2
SC van Schalkwyk ,United States of America,2024,2024,14,14,4,4,4,0,0,1
SZ Vayani ,MWest Indies,2023,2024,23,23,4,4,4,0,0,1
JK Vifah ,GHA,2019,2024,31,31,4,4,4,0,0,3
K Vislapuu ,EST,2021,2024,20,20,4,4,4,0,0,1
D Visser ,Samoa,2024,2024,6,6,4,4,4,0,0,3
ZXM Vukusic ,CRT,2024,2024,4,4,4,4,4,0,0,2
C Waiswa ,UGA,2019,2021,10,10,4,4,4,0,0,1
SM Warnakulasuriya ,Fran,2023,2023,8,8,4,4,4,0,0,1
SMK Waththage ,CZK-R,2019,2022,19,19,4,4,4,0,0,1
RR Watson ,Scotland,2007,2010,10,9,4,4,4,0,0,2
K Weeraratne ,Sri Lanka,2008,2009,5,5,4,4,4,0,0,2
Wei Guo Lei ,CHN,2023,2024,11,11,4,4,4,0,0,2
AG Weligamage ,HUN,2021,2022,14,14,4,4,4,0,0,2
D Wotu ,VAN,2022,2024,17,17,4,4,4,0,0,1
Yasir Shah ,Pakistan,2011,2011,2,2,4,4,4,0,0,3
S Yeshey ,BHU,2022,2024,23,23,4,4,4,0,0,1
Zahid Zadran ,GER,2023,2024,8,8,4,4,4,0,0,2
Zameer Khan ,DEN,2019,2021,8,8,4,3,1,2,1,2
Zeshan Arif ,Aut,2019,2024,8,8,4,4,4,0,0,2
Ziaur Rahman ,BAN,2012,2014,14,14,4,4,4,0,0,2
Abdullah Shafique ,Pakistan,2020,2023,6,6,3,3,3,0,0,2
Abdul Stanikzai ,GER,2022,2022,5,5,3,3,3,0,0,2
Abdur Rahman Sudais ,SWE,2023,2024,7,7,3,3,3,0,0,1
KH Abe ,Japan,2024,2024,21,21,3,3,3,0,0,1
Abhishek Sharma ,India,2024,2024,12,12,3,3,3,0,0,1
Aftab Alam ,Afghanistan,2012,2018,12,12,3,3,3,0,0,2
RDB Ahir ,PAN,2023,2023,8,8,3,3,3,0,0,1
Ainool Haqqiem ,MAS,2019,2019,4,4,3,1,0,1,2,2
D Ajekun ,NGA,2019,2024,29,28,3,3,3,0,0,1
F Akankwasa ,UGA,2020,2022,32,31,3,3,3,0,0,2
Akbar Khan ,Hong Kong,2023,2023,7,7,3,3,3,0,0,1
Ali Yalmaz ,HUN,2021,2024,14,13,3,3,3,0,0,1
TP Allen ,United States of America,2019,2019,5,5,3,3,3,0,0,1
Amir Mangal ,GER,2019,2020,10,10,3,3,3,0,0,2
Amir Sharif ,ITA,2021,2021,3,3,3,3,3,0,0,2
Ammar Zuhdi Hazalan ,MAS,2022,2022,3,3,3,2,0,2,1,2
MK Anafie ,GHA,2021,2021,10,10,3,3,3,0,0,1
Anasim Khan ,BHR,2019,2021,12,12,3,3,3,0,0,1
JM Anderson ,England,2007,2009,19,19,3,3,3,0,0,1
R Ankad ,Mex,2019,2024,15,15,3,3,3,0,0,1
Anowarul Islam ,THA,2019,2019,4,4,3,3,3,0,0,2
Anser Mehmood ,SUI,2021,2022,7,7,3,3,3,0,0,1
Anwar Arudin ,MAS,2019,2021,21,20,3,3,3,0,0,1
Asad Shafiq ,Pakistan,2010,2012,10,10,3,3,3,0,0,1
Asif Khan ,United Arab Emirates,2023,2024,32,32,3,3,3,0,0,1
NJ Astle ,New Zealand,2005,2006,4,4,3,3,3,0,0,2
TD Astle ,New Zealand,2016,2021,5,5,3,3,3,0,0,1
Avi Dixit ,SGP,2019,2024,14,14,3,3,3,0,0,1
G Axtell ,BHR,2022,2022,2,2,3,3,3,0,0,2
Azam Khalil ,SWE,2022,2022,9,9,3,3,3,0,0,2
Azhar Andani ,PORT,2021,2024,15,15,3,3,3,0,0,1
Aziz Sualley ,GHA,2021,2024,13,13,3,3,3,0,0,2
OEG Baartman ,South Africa,2024,2024,10,10,3,3,3,0,0,2
Babar Ali ,BHR,2019,2019,3,3,3,3,3,0,0,1
DS Bajwa ,Canada,2023,2024,12,12,3,3,3,0,0,1
Bakhtiar Tahiri ,BUL,2020,2022,14,13,3,3,3,0,0,1
J Baleicikoibia ,Fiji,2022,2022,6,6,3,3,3,0,0,2
AR Balla ,CAM,2021,2024,16,16,3,3,3,0,0,1
OGL Bascome ,BER,2019,2021,17,17,3,3,3,0,0,1
JW Batinibulu ,Fiji,2022,2023,6,6,3,3,3,0,0,2
Baz Aybui ,SWE,2021,2022,10,10,3,3,3,0,0,1
C Bisson ,JER,2019,2019,14,14,3,3,3,0,0,1
TA Blundell ,New Zealand,2017,2024,9,9,3,3,2,1,0,1
S Bogdos ,GRC,2022,2022,4,4,3,2,0,2,1,2
DL Brangman ,BER,2019,2023,16,16,3,3,3,0,0,1
DG Brownlie ,New Zealand,2010,2014,5,5,3,3,3,0,0,1
DE Burgess ,Samoa,2019,2024,9,9,3,3,3,0,0,1
IG Butler ,New Zealand,2009,2013,19,19,3,3,3,0,0,1
P Cabebula ,Fiji,2022,2023,10,10,3,3,3,0,0,1
J Campbell ,Zimbabwe,2024,2024,9,9,3,3,3,0,0,1
C Carter ,Hong Kong,2015,2017,10,10,3,2,0,2,1,1
RD Chahar ,India,2019,2021,6,6,3,3,3,0,0,2
ARA Chambers ,PORT,2021,2024,17,17,3,3,3,0,0,1
Charles Trott ,BER,2023,2023,5,5,3,3,3,0,0,1
Chaudhary Akram ,NOR,2023,2024,4,4,3,3,3,0,0,2
M Cohen ,ISR,2022,2022,3,3,3,1,1,0,2,2
NG Collins ,FIN,2019,2023,24,24,3,3,3,0,0,1
PC Connell ,Ireland,2008,2010,9,8,3,3,3,0,0,1
CJ Dala ,South Africa,2018,2021,10,10,3,3,3,0,0,1
SM Davies ,England,2009,2011,5,5,3,2,0,2,1,2
CD de Lange ,Scotland,2015,2017,8,7,3,3,3,0,0,1
CJ Delany ,GIBR,2019,2021,13,13,3,3,3,0,0,1
P Dhiman ,ESP,2022,2022,4,4,3,3,3,0,0,1
Dipanjan Dey ,SWE,2021,2021,6,6,3,3,3,0,0,1
DT Doram ,NED,2024,2024,6,6,3,3,3,0,0,1
J Dzulfikar ,INA,2024,2024,7,7,3,3,3,0,0,2
Elan Talker ,ISR,2022,2024,8,8,3,3,3,0,0,2
L Erdenebulgan ,MNG,2023,2024,15,15,3,3,3,0,0,2
H Fennell ,Arg,2019,2024,20,20,3,3,3,0,0,1
CRD Fernando ,Sri Lanka,2006,2016,18,18,3,3,3,0,0,1
Firas Hussain ,BUL,2024,2024,7,7,3,3,3,0,0,1
JD Freyone ,GIBR,2019,2023,15,15,3,3,3,0,0,2
LM Gabriel ,LES,2022,2024,17,17,3,3,3,0,0,2
M Gherasim ,ROM,2020,2022,12,12,3,3,3,0,0,2
MK Gnanasekaram ,SUI,2023,2023,7,7,3,3,3,0,0,1
LF Goncalves ,BRA,2019,2019,3,3,3,1,0,1,2,2
A Gorawara ,Hong Kong,2023,2024,4,4,3,3,1,2,0,1
JOA Gordon ,Canada,2013,2024,17,16,3,3,3,0,0,1
K Gore ,United States of America,2019,2021,8,8,3,3,3,0,0,1
H Gori ,CZK-R,2019,2020,11,11,3,3,3,0,0,1
PB Gouge ,JER,2023,2024,4,4,3,2,2,0,1,2
Z Groenewald ,Namibia,2019,2019,10,10,3,3,3,0,0,1
Gurdeep Singh ,Kenya,2021,2024,11,10,3,3,3,0,0,2
Habib Ahmadzai ,Aut,2019,2022,10,10,3,3,3,0,0,1
Hamid Hassan ,Afghanistan,2010,2021,25,25,3,3,3,0,0,1
Hamid Mahmood ,SWE,2022,2024,13,13,3,3,3,0,0,2
GM Hamilton ,Scotland,2007,2010,12,11,3,3,3,0,0,2
Hamza Dar ,ESP,2019,2024,28,28,3,3,3,0,0,1
F Hand ,Ireland,2022,2024,13,13,3,3,3,0,0,1
Haris Sohail ,Pakistan,2013,2019,14,14,3,3,3,0,0,2
E Haven ,Bhm,2021,2022,8,8,3,2,1,1,1,2
MJ Henry ,New Zealand,2014,2024,18,17,3,3,3,0,0,1
FFJ Heo ,INA,2024,2024,5,5,3,3,3,0,0,2
P Hingorani ,ROM,2023,2024,8,8,3,3,3,0,0,2
JR Hopes ,Australia,2005,2010,12,12,3,3,3,0,0,1
S Houghton ,CRT,2024,2024,5,5,3,3,1,2,0,1
Ibrarul Haq ,KSA,2019,2019,5,5,3,3,3,0,0,3
Iftekar Jaman ,CYP,2021,2022,5,5,3,3,3,0,0,2
Imran Farhat ,Pakistan,2010,2011,7,7,3,3,3,0,0,1
Imran Khan (1) ,Pakistan,2015,2015,3,3,3,3,3,0,0,2
Inam-ul-Haq ,QAT,2019,2019,11,11,3,3,3,0,0,1
MM Iqbal ,Scotland,2012,2013,6,6,3,3,3,0,0,1
JM Iradukunda ,RWN,2023,2023,3,3,3,3,3,0,0,3
AE Isesele ,NGA,2022,2023,13,13,3,3,3,0,0,2
Ismaeel Zia ,SWE,2022,2022,8,8,3,1,1,0,2,2
Ismaila Tamba ,GMB,2022,2024,12,12,3,3,3,0,0,2
Ismail Ali ,MDV,2023,2024,18,18,3,3,3,0,0,1
S Iturbe ,Arg,2023,2024,2,2,3,3,0,3,0,2
Izatullah Dawlatzai (AFG/GER),NA,2012,2020,16,16,3,3,3,0,0,2
E Jabarkhel ,LUX,2023,2023,10,10,3,3,3,0,0,2
ZR Jabeneke ,TAN,2021,2024,7,7,3,3,3,0,0,2
W Jackson ,MWest Indies,2021,2023,4,4,3,3,3,0,0,2
B Jagroo ,Bhm,2021,2022,9,9,3,3,3,0,0,1
Jahurul Islam ,BAN,2010,2013,3,3,3,3,3,0,0,1
Jaweed Sadran ,Aut,2021,2023,20,20,3,3,3,0,0,1
G Johnson ,STHEL,2022,2022,7,6,3,3,3,0,0,2
S Joseph ,West Indies,2024,2024,9,9,3,3,3,0,0,1
Junaid Siddiqui ,Canada,2012,2024,22,22,3,3,3,0,0,1
AUKDS Kalugala ,CYP,2022,2024,10,10,3,3,3,0,0,2
AB Kamara ,Sri LankaE,2021,2021,9,9,3,3,3,0,0,1
Kashif Siddique ,KSA,2022,2024,11,11,3,3,3,0,0,1
N Katechis ,GRC,2024,2024,4,4,3,3,0,3,0,1
K Kato-Stafford ,Japan,2024,2024,10,10,3,3,3,0,0,1
I Katzarski ,BUL,2019,2022,18,18,3,3,3,0,0,2
A Kaul ,SGP,2022,2024,11,11,3,3,3,0,0,1
J Kemp ,JER,2024,2024,5,5,3,1,0,1,2,1
JM Kemp ,South Africa,2005,2007,8,8,3,3,3,0,0,1
Khalid Shah ,United Arab Emirates,2023,2023,8,8,3,3,3,0,0,1
F Khaliq ,Belg,2024,2024,8,8,3,3,3,0,0,2
J Kila ,Papau New Guinea,2019,2022,16,16,3,3,3,0,0,2
Kim Daeyeon ,SKOR,2022,2024,10,10,3,3,3,0,0,2
AK Kitchen ,New Zealand,2017,2018,5,4,3,3,3,0,0,2
N Knights ,IOM,2020,2023,18,17,3,3,3,0,0,1
B Kohler-Cadmore ,GER,2024,2024,4,4,3,3,3,0,0,2
IGTR Kumara ,MDV,2020,2020,3,3,3,3,3,0,0,3
UKPW Kumaranayaka ,KUW,2019,2021,8,8,3,3,3,0,0,1
P Kumbhare ,Japan,2022,2024,20,20,3,3,3,0,0,1
JS Kundi ,Kenya,2019,2024,13,13,3,3,3,0,0,1
RAS Lakmal ,Sri Lanka,2011,2019,11,11,3,3,3,0,0,1
D Finau ,Samoa,2022,2024,12,12,3,3,3,0,0,1
A Lark ,Aut,2019,2019,5,5,3,3,3,0,0,1
Lemar Momand ,SWE,2021,2022,7,7,3,3,3,0,0,2
H Lin Aung ,MYAN,2023,2024,19,19,3,3,3,0,0,1
H Lin Oo ,MYAN,2023,2024,17,17,3,3,3,0,0,2
R Lutaaya ,UGA,2022,2024,20,20,3,3,3,0,0,1
CA Lynn ,Australia,2014,2018,18,17,3,3,3,0,0,1
TM Macalou ,Mali,2022,2024,15,14,3,3,3,0,0,2
WK McCallan ,Ireland,2008,2009,9,8,3,3,3,0,0,1
R McLaren ,South Africa,2009,2014,12,12,3,3,3,0,0,1
CD McMillan ,New Zealand,2005,2007,8,8,3,3,3,0,0,2
GT Main ,Scotland,2015,2024,16,14,3,3,3,0,0,2
L Makgale ,BOT,2023,2023,8,8,3,3,3,0,0,1
JN Malan ,South Africa,2019,2021,11,11,3,3,3,0,0,1
SKR Mallidi ,SWE,2024,2024,3,3,3,3,3,0,0,2
Mamoon Latif ,Belg,2019,2021,11,11,3,3,3,0,0,2
V Manakitoga ,Fiji,2023,2023,2,2,3,3,3,0,0,2
Mandeep Singh ,NOR,2024,2024,5,5,3,3,3,0,0,1
BAD Manenti ,ITA,2023,2023,5,5,3,3,3,0,0,2
B Maphosa ,BOT,2022,2023,10,9,3,3,3,0,0,1
SE Marsh ,Australia,2008,2016,15,15,3,3,3,0,0,2
A Martel ,GUE,2022,2024,18,18,3,3,3,0,0,2
T Martin ,LUX,2023,2024,6,6,3,3,3,0,0,1
I Master ,BOT,2019,2022,6,6,3,3,3,0,0,1
RD McCann ,Ireland,2012,2012,3,3,3,1,0,1,2,2
Md Shafiqul Haque ,THA,2019,2019,4,4,3,1,0,1,2,1
Junaid Mehmood ,NOR,2021,2024,8,8,3,3,0,3,0,1
Mien Mehmood ,PORT,2019,2021,7,7,3,3,3,0,0,1
AJ Michael ,Samoa,2019,2022,10,10,3,3,3,0,0,2
DP Michael ,Samoa,2019,2022,10,10,3,3,3,0,0,2
Mirza Ahsan ,Aut,2019,2023,30,30,3,3,3,0,0,1
T Mishra ,Kenya,2007,2013,15,15,3,3,3,0,0,1
Mohamed Shiyam ,MDV,2024,2024,5,5,3,3,3,0,0,2
Mohammad Amin ,KUW,2019,2024,11,11,3,3,3,0,0,1
Mohammad Asif ,Pakistan,2006,2010,11,11,3,3,3,0,0,1
Mohammad Sami ,Pakistan,2010,2016,13,13,3,3,3,0,0,1
Mudassar Muhammad ,GER,2019,2023,10,10,3,3,3,0,0,1
Iqbal Mudassir ,SKOR,2022,2024,10,10,3,3,3,0,0,1
N Mugabe ,Kenya,2023,2024,25,25,3,3,3,0,0,2
Muhaddis Muhaddis ,INA,2023,2023,4,4,3,3,3,0,0,1
Fahim Bhatti ,Belg,2022,2024,14,14,3,3,3,0,0,1
Muhammad Kashif ,KUW,2019,2022,21,21,3,3,3,0,0,1
Muhammad Wafiq ,MAS,2019,2024,32,31,3,3,3,0,0,1
Muhammad Younis ,BHR,2020,2022,14,14,3,3,3,0,0,2
JM Muirhead ,Australia,2014,2014,5,5,3,3,3,0,0,1
JK Mukhiya ,NEP,2014,2022,10,10,3,3,3,0,0,2
AA Mulla ,Canada,2008,2008,4,4,3,1,0,1,2,1
TJ Murtagh ,Ireland,2012,2016,14,14,3,3,3,0,0,1
Musawar Shah ,QAT,2019,2024,14,14,3,3,3,0,0,1
Musa Twala ,SWZ,2022,2022,5,5,3,2,1,1,1,1
Muzammil Shahzad ,PHI,2022,2022,3,3,3,3,3,0,0,1
Naeem Gull (SWA/SWZ),NA,2021,2022,13,12,3,3,3,0,0,1
Najeeb Tarakai ,Afghanistan,2014,2019,12,12,3,3,3,0,0,2
N Nankov ,BUL,2019,2021,5,5,3,3,3,0,0,1
Naseem Shah ,Pakistan,2022,2024,30,30,3,3,3,0,0,1
M Nasim Baras ,Afghanistan,2015,2015,3,3,3,3,3,0,0,2
A Nathwani ,Aut,2019,2023,29,29,3,3,3,0,0,1
PM Nevill ,Australia,2016,2016,9,9,3,2,0,2,1,1
Ngawang Thinley ,BHU,2022,2024,11,11,3,3,3,0,0,1
B Niaz ,Belg,2021,2024,26,26,3,3,3,0,0,1
HM Nicholls ,New Zealand,2016,2021,10,10,3,3,3,0,0,2
S Nsubuga ,UGA,2023,2023,15,15,3,3,3,0,0,2
Nyein Cham Soe ,MYAN,2023,2024,16,16,3,3,3,0,0,1
Obed Yosef ,VAN,2022,2023,8,8,3,3,3,0,0,1
DO Obuya ,Kenya,2007,2012,10,10,3,2,1,1,1,1
E Ochieng ,Kenya,2019,2022,10,9,3,3,3,0,0,1
OE Olaleye ,NGA,2021,2024,11,11,3,3,3,0,0,1
Omar Hayat ,DEN,2019,2022,8,8,3,3,3,0,0,1
Omar Hussain ,LES,2021,2024,9,9,3,3,3,0,0,1
H Patel ,Canada,2010,2021,15,15,3,3,3,0,0,1
RB Patel ,BUL,2020,2021,10,9,3,3,3,0,0,1
SJ Patel ,CZK-R,2021,2022,10,10,3,3,3,0,0,1
SR Patel ,England,2011,2013,18,18,3,3,3,0,0,1
JL Pattinson ,Australia,2011,2012,4,4,3,3,3,0,0,2
KMA Paul ,West Indies,2018,2022,23,23,3,3,3,0,0,1
S Pillai ,CRC,2019,2024,8,8,3,3,3,0,0,1
S Pradhan ,BHU,2022,2024,26,26,3,3,3,0,0,1
Prashant Shukla ,SWE,2023,2024,6,6,3,3,3,0,0,2
RW Price ,Zimbabwe,2008,2012,16,16,3,3,3,0,0,1
S Qeshile ,South Africa,2019,2019,2,2,3,3,0,3,0,2
AA Rahayu ,INA,2023,2024,11,11,3,3,3,0,0,1
KC Ramamoorthy ,INA,2022,2024,24,24,3,3,3,0,0,1
H Rathod ,QAT,2023,2024,19,19,3,3,3,0,0,1
S Ravoka ,Fiji,2022,2022,6,6,3,3,3,0,0,1
AJ Redmond ,New Zealand,2009,2010,7,7,3,3,3,0,0,2
KA Reynolds ,Blz,2019,2019,3,3,3,3,3,0,0,2
Riaz Afridi ,CZK-R,2023,2024,4,4,3,3,3,0,0,1
T Ritawa ,COK,2022,2024,11,11,3,3,3,0,0,1
AAP Rivero ,Arg,2023,2024,9,9,3,3,3,0,0,2
Rizwan Mahmood ,DEN,2019,2023,13,11,3,3,3,0,0,2
PS Roberts ,CRT,2024,2024,4,4,3,3,3,0,0,1
LH Rodrigues ,BRA,2019,2024,5,5,3,3,3,0,0,1
Rohail Nazir ,Pakistan,2023,2023,3,3,3,3,0,3,0,2
Rony Talukdar ,BAN,2015,2023,11,11,3,2,2,0,1,1
MJ Ross ,ITA,2019,2019,8,7,3,3,3,0,0,2
S Rukmal ,SEY,2022,2024,12,11,3,3,3,0,0,1
Saad Khan ,KSA,2022,2024,16,16,3,3,3,0,0,1
Sahil Chauhan ,EST,2023,2024,13,13,3,3,3,0,0,2
NA Saini ,India,2019,2021,11,10,3,3,3,0,0,2
R Sai Kishore ,India,2023,2023,3,3,3,3,3,0,0,3
N Salekar ,THA,2024,2024,4,4,3,3,3,0,0,2
Salman Butt ,Pakistan,2007,2010,24,24,3,3,3,0,0,1
Samir Patel ,LES,2021,2022,13,13,3,3,3,0,0,1
Samiullah Rahmani ,SWE,2023,2024,9,9,3,3,3,0,0,2
Sandeep Goud ,Bhm,2021,2023,13,13,3,3,3,0,0,2
S Sankar ,KSA,2024,2024,3,3,3,3,0,3,0,2
S Santhirakumaran ,Fran,2021,2023,6,6,3,3,3,0,0,2
Amoluk Singh ,GHA,2021,2022,15,15,3,3,3,0,0,2
Selim Salau ,NGA,2024,2024,6,6,3,3,3,0,0,1
N Senamontree ,THA,2020,2024,33,33,3,3,3,0,0,1
SMSM Senanayake ,Sri Lanka,2012,2016,24,24,3,3,3,0,0,1
Shahzaib Hasan ,Pakistan,2009,2010,10,10,3,3,3,0,0,2
Shaik Basha ,TAN,2023,2023,9,9,3,3,3,0,0,1
Shakeel Ahmed ,OMA,2023,2024,26,26,3,3,3,0,0,1
Shayan Jahangir ,United States of America,2024,2024,14,14,3,3,3,0,0,1
NK Shetty ,Mex,2019,2019,2,2,3,3,3,0,0,2
Shivam Mavi ,India,2023,2023,6,6,3,3,3,0,0,2
Shoaib Rafiq ,Mex,2023,2024,7,7,3,3,3,0,0,2
Sidhant Singh ,SGP,2019,2020,11,11,3,3,3,0,0,1
ED Silva ,KUW,2021,2022,12,12,3,3,3,0,0,2
LA Simango ,MOZ,2019,2022,21,21,3,3,3,0,0,2
K Sinclair ,West Indies,2021,2021,6,6,3,3,3,0,0,1
G Singhdeo ,CRC,2024,2024,5,5,3,3,0,3,0,2
L Sipamla ,South Africa,2019,2024,11,11,3,3,3,0,0,1
S Siriotis ,GRC,2021,2021,4,4,3,3,3,0,0,1
C Smith (IOM/MAS),NA,2021,2023,6,6,3,3,3,0,0,1
NL Smith ,ITA,2021,2021,6,6,3,3,3,0,0,2
A Sokovagone ,Fiji,2024,2024,6,6,3,3,3,0,0,1
VS Solanki ,England,2005,2007,3,3,3,3,1,2,0,2
AL Stephen ,VAN,2019,2024,16,16,3,3,3,0,0,1
Sufyan Mehmood ,OMA,2015,2024,8,8,3,3,3,0,0,1
AO Suji ,Kenya,2007,2010,8,8,3,3,3,0,0,1
V Sukumaran ,United Arab Emirates,2024,2024,10,10,3,3,3,0,0,1
A Symonds ,Australia,2005,2009,14,14,3,3,3,0,0,1
Tafseer Ali ,NOR,2019,2023,12,12,3,3,3,0,0,1
Tahir Patel ,SWZ,2022,2022,6,6,3,3,3,0,0,1
SW Tait ,Australia,2007,2016,21,21,3,3,3,0,0,1
N Tanner ,PHI,2024,2024,7,7,3,3,3,0,0,1
Tauqeer Hussain ,ESP,2019,2020,6,6,3,3,3,0,0,1
C Tear ,Scotland,2024,2024,5,5,3,2,0,2,1,3
Tejwinder Singh ,CYP,2021,2022,11,11,3,3,3,0,0,1
J Theron (SA/USA),NA,2010,2022,18,18,3,3,3,0,0,1
Thuya Aung ,MYAN,2023,2024,19,19,3,2,2,0,1,1
OFJ Tonuu ,Samoa,2019,2019,4,4,3,3,0,3,0,1
RA Tripathi ,India,2023,2023,5,5,3,3,3,0,0,1
A Turay ,Sri LankaE,2022,2024,19,19,3,3,3,0,0,1
DJ Turkich ,CRT,2022,2024,9,9,3,3,3,0,0,2
M Ozturk ,TKY,2022,2024,12,11,3,3,3,0,0,1
HER Tyler ,PHI,2019,2024,22,22,3,2,0,2,1,1
E Ul Haq ,NOR,2019,2021,10,10,3,3,3,0,0,1
Sana Ullah ,SKOR,2022,2022,4,4,3,3,3,0,0,2
Umair Sharif ,KSA,2023,2023,8,8,3,3,3,0,0,2
Umar Nawaz ,SWE,2022,2022,9,9,3,3,3,0,0,2
JD Unadkat ,India,2016,2018,10,10,3,3,3,0,0,1
Usman Khan ,Pakistan,2024,2024,13,13,3,3,3,0,0,1
D Uwimana ,RWN,2021,2021,6,6,3,3,0,3,0,2
P Vekaria ,RWN,2021,2021,8,8,3,3,3,0,0,1
G Venkateswaran ,LUX,2019,2023,17,17,3,3,3,0,0,1
C Veretaki ,Fiji,2023,2023,4,4,3,0,0,0,3,2
J Vijay ,PORT,2024,2024,5,5,3,3,0,3,0,3
M Vijay ,India,2010,2015,9,9,3,3,3,0,0,1
KA Vimlesh ,ROM,2023,2024,5,5,3,3,3,0,0,2
M Vivekanandan ,MNG,2024,2024,13,13,3,3,3,0,0,1
AC Voges ,Australia,2007,2013,7,7,3,3,3,0,0,1
Waji Ul Hassan ,KSA,2024,2024,16,16,3,3,3,0,0,2
Wang Liuyang ,CHN,2023,2023,4,4,3,0,0,0,3,3
Waqar Zalmai ,Aut,2021,2024,10,10,3,3,3,0,0,1
TS Waqavakatoga ,Fiji,2022,2024,10,10,3,3,3,0,0,1
Waseeq Ahmed ,BHR,2021,2022,16,16,3,3,3,0,0,1
Waseem Yaqoob ,LES,2022,2024,17,17,3,3,3,0,0,1
BJ Watling ,New Zealand,2009,2014,5,5,3,3,1,2,0,1
C Webster ,IOM,2023,2023,6,5,3,3,3,0,0,1
OJ Webster ,IOM,2020,2024,6,6,3,3,3,0,0,1
DS Wesonga ,Kenya,2021,2021,3,3,3,3,3,0,0,2
T Whiteman ,LUX,2019,2021,14,14,3,3,3,0,0,1
N Wijesekera ,Aut,2021,2023,10,10,3,3,3,0,0,1
CG Williams ,Namibia,2019,2022,35,35,3,3,3,0,0,1
LB Williams ,South Africa,2021,2024,15,15,3,3,3,0,0,1
UT Yadav ,India,2012,2022,9,9,3,3,3,0,0,1
HN Ya France ,Namibia,2019,2023,21,21,3,3,3,0,0,1
Yair Nagavkar ,ISR,2022,2024,8,8,3,3,3,0,0,1
Yasir Mohammad ,United States of America,2021,2024,6,6,3,3,3,0,0,1
Zaki Ul Hassan ,Belg,2019,2024,8,8,3,3,3,0,0,2
Zaman Khan ,Pakistan,2023,2024,10,10,3,3,3,0,0,1
M Abdulla ,MWest Indies,2019,2021,10,10,2,2,2,0,0,1
Abdullah Khan Lodhi ,TKY,2024,2024,4,4,2,1,1,0,1,1
Abdul Razzaq ,Pakistan,2006,2013,32,32,2,2,2,0,0,1
AS Abioye ,NGA,2019,2019,5,5,2,2,2,0,0,1
IKO Aboagye ,GHA,2019,2019,4,4,2,2,2,0,0,1
RA Abolarin ,NGA,2019,2021,10,10,2,2,2,0,0,1
Abubacarr Kuyateh ,GMB,2022,2024,11,11,2,2,2,0,0,1
Abul Farhad ,CZK-R,2022,2024,9,9,2,2,2,0,0,1
Abu Hider ,BAN,2016,2018,13,12,2,2,2,0,0,1
AG Achar ,SGP,2019,2023,9,9,2,2,2,0,0,1
Adeel Tariq ,Aut,2024,2024,2,2,2,2,2,0,0,2
Adil Butt ,KSA,2020,2020,3,3,2,2,2,0,0,1
Aditya Panwar ,EST,2023,2024,6,6,2,2,2,0,0,1
Adnan Razzaq ,Belg,2021,2024,10,10,2,2,2,0,0,1
N Advani ,GIBR,2019,2024,9,9,2,2,2,0,0,1
Afsar Zazai ,Afghanistan,2013,2023,8,7,2,0,0,0,2,1
Aftab Kayani ,ROM,2020,2022,8,8,2,2,2,0,0,1
Ahmad Khalid Ahmadzai ,Belg,2022,2024,6,6,2,2,2,0,0,1
Rehan Ahmed ,England,2023,2024,10,10,2,2,2,0,0,1
Ahmed Baladraf ,KSA,2023,2023,9,9,2,2,2,0,0,1
Ali Waqar ,CZK-R,2021,2021,6,6,2,2,2,0,0,1
Akif Raja ,United Arab Emirates,2021,2024,18,18,2,2,2,0,0,1
AD Algar ,ESP,2020,2023,6,5,2,2,0,2,0,2
Ali Khan ,United States of America,2021,2024,16,16,2,2,2,0,0,1
Ali Zaheer ,KUW,2022,2023,6,6,2,2,2,0,0,1
DI Allan ,Kenya,2012,2013,10,10,2,2,2,0,0,1
Alok Kapali ,BAN,2007,2011,7,7,2,2,2,0,0,1
A Amado ,ISR,2022,2022,3,3,2,2,2,0,0,1
TR Ambrose ,England,2008,2008,1,1,2,1,0,1,1,2
Ameer Saiyed ,BOT,2019,2023,16,16,2,2,2,0,0,1
Amjad Khan ,United Arab Emirates,2015,2016,4,4,2,2,2,0,0,1
Aphsal Ashraf ,KUW,2020,2020,5,5,2,2,2,0,0,1
V Aritharan ,GER,2022,2024,4,4,2,2,2,0,0,1
P Arora ,Mex,2019,2024,5,5,2,2,2,0,0,1
Ashfaq Ahmed ,United Arab Emirates,2018,2019,12,12,2,2,2,0,0,1
Ashiqullah Said ,Belg,2019,2021,12,12,2,2,2,0,0,1
Asrar Ahmed ,GRC,2019,2021,7,7,2,2,2,0,0,1
Assad Borham ,QAT,2022,2022,7,7,2,2,2,0,0,1
A Athanaze ,West Indies,2024,2024,4,4,2,2,2,0,0,1
R Athapaththu ,ROM,2023,2024,7,7,2,2,2,0,0,1
Atif Mehmood ,ESP,2019,2024,30,29,2,2,2,0,0,1
Azeem Nazir ,SUI,2022,2022,4,4,2,2,2,0,0,1
J Baguma ,UGA,2022,2024,14,13,2,2,2,0,0,1
PS Bais ,Mex,2023,2024,9,9,2,2,2,0,0,2
Baljit Singh ,ITA,2019,2022,11,10,2,2,2,0,0,1
JC Balt ,Namibia,2024,2024,5,5,2,2,2,0,0,1
KNA Bandara ,Sri Lanka,2021,2023,6,6,2,2,2,0,0,1
AA Banner ,Blz,2019,2021,9,9,2,2,2,0,0,2
LJ Barker ,GUE,2019,2020,10,10,2,2,2,0,0,1
GEF Barnett ,Canada,2008,2010,5,5,2,2,2,0,0,1
CD Barnwell ,West Indies,2011,2013,6,6,2,2,2,0,0,1
JR Barry ,Bhm,2021,2023,10,10,2,2,2,0,0,1
AR Berenger ,QAT,2021,2021,4,4,2,2,2,0,0,1
JG Bethell ,England,2024,2024,7,7,2,2,2,0,0,1
A Bhagwat ,Hong Kong,2019,2019,4,4,2,2,0,2,0,2
H Bharadwaj ,SGP,2023,2024,12,12,2,2,2,0,0,1
RA Bhatti ,Canada,2012,2012,4,4,2,1,0,1,1,1
K Birkenstock ,Namibia,2019,2021,9,9,2,2,2,0,0,1
WK Bitis ,CRT,2022,2023,9,8,2,2,2,0,0,1
ML Bojang ,GMB,2022,2023,8,8,2,2,2,0,0,1
DE Bollinger ,Australia,2011,2014,9,9,2,2,2,0,0,1
P Bosnjak ,CRT,2023,2024,9,8,2,2,0,2,0,1
JT Brassell ,Namibia,2024,2024,13,12,2,2,2,0,0,1
JP Bray ,Ireland,2009,2009,2,2,2,2,2,0,0,1
GB Brent ,Zimbabwe,2006,2007,3,3,2,2,2,0,0,2
PR Brown ,England,2019,2019,4,4,2,2,2,0,0,1
P Buccimazza ,PORT,2019,2021,7,7,2,2,0,2,0,1
AF Buurman ,NED,2010,2010,4,4,2,1,0,1,1,2
ML Castillo ,Blz,2021,2021,5,5,2,2,2,0,0,1
K Cawte ,IOM,2022,2024,14,14,2,2,2,0,0,1
DL Chahar ,India,2018,2023,25,25,2,2,2,0,0,1
VD Chandra ,PAN,2019,2019,3,3,2,2,0,2,0,1
BB Chari ,Zimbabwe,2019,2019,3,3,2,2,2,0,0,1
A Chaubey ,CRT,2024,2024,4,4,2,2,2,0,0,2
PP Chawla ,India,2010,2012,7,7,2,2,2,0,0,2
P Chin ,CAY,2022,2023,9,9,2,2,0,2,0,1
HA Chohan ,TAN,2021,2024,32,32,2,2,2,0,0,1
JA Clarkson ,New Zealand,2024,2024,8,7,2,2,2,0,0,1
G Coetzee ,South Africa,2023,2024,10,10,2,2,2,0,0,1
J Coetzee ,THA,2023,2024,19,19,2,2,2,0,0,1
A Conteh ,GMB,2022,2023,9,9,2,2,2,0,0,1
CK Coventry ,Zimbabwe,2010,2015,13,13,2,2,1,1,0,1
KM Dabengwa ,Zimbabwe,2006,2010,8,8,2,2,2,0,0,1
M Dale-Bradley ,GUE,2023,2024,14,14,2,2,2,0,0,1
P Danci ,ROM,2019,2020,4,4,2,2,2,0,0,2
J Danikula ,CRT,2024,2024,5,5,2,2,2,0,0,1
Danyal Raja ,BUL,2023,2024,11,10,2,2,2,0,0,1
RR David ,Canada,2008,2008,4,4,2,2,2,0,0,1
JM Davison ,Canada,2008,2010,5,5,2,2,2,0,0,1
LA Dawson ,England,2016,2022,11,11,2,2,2,0,0,1
TB de Bruyn ,South Africa,2017,2017,2,2,2,2,2,0,0,2
N Deonarine ,West Indies,2010,2013,8,8,2,2,2,0,0,2
TU Deshpande ,India,2024,2024,2,2,2,2,2,0,0,2
IA De Silva ,BUL,2020,2022,35,34,2,2,2,0,0,1
AP Devcich ,New Zealand,2013,2014,4,4,2,2,2,0,0,2
Dharmang Patel ,QAT,2022,2022,5,5,2,2,2,0,0,1
R Dhawan ,India,2016,2016,1,1,2,2,2,0,0,2
A Dhingra ,LUX,2021,2023,18,18,2,2,2,0,0,1
HB Dickson ,COK,2022,2024,9,9,2,2,2,0,0,1
A Djorovic ,SRB,2019,2023,11,11,2,2,2,0,0,1
ST Doheny ,Ireland,2023,2023,3,3,2,2,0,2,0,1
TJ Draca ,ITA,2024,2024,4,4,2,2,2,0,0,2
DC Drakes ,West Indies,2021,2022,10,10,2,2,2,0,0,1
GD Drummond ,Scotland,2008,2013,17,17,2,2,2,0,0,1
J Drysdale ,United States of America,2024,2024,8,8,2,2,2,0,0,1
B Dugic ,SRB,2019,2024,11,11,2,2,2,0,0,1
AB Dursak ,TKY,2019,2019,4,4,2,2,2,0,0,2
Ehsan Nawaz ,Hong Kong,2014,2024,6,6,2,2,2,0,0,2
E Kuchey ,FIN,2024,2024,4,4,2,2,2,0,0,2
I Elec ,TKY,2022,2024,12,11,2,2,2,0,0,1
GDR Eranga ,Canada,2019,2019,9,9,2,2,2,0,0,1
E Ernest ,Sri LankaE,2021,2021,10,10,2,2,2,0,0,2
J Evans ,ISR,2022,2024,9,9,2,2,2,0,0,1
Faheem Nellancheri ,FIN,2023,2024,13,13,2,2,2,0,0,1
Faisal Mehmood ,Belg,2021,2023,5,5,2,2,2,0,0,1
Faran Afzal ,ESP,2019,2019,9,9,2,2,2,0,0,1
G Fatouros ,GRC,2022,2022,4,4,2,2,2,0,0,1
AM Fernando ,Sri Lanka,2022,2024,7,7,2,2,2,0,0,1
N Pradeep ,Sri Lanka,2016,2021,16,16,2,2,2,0,0,1
B Fernando ,Sri Lanka,2015,2024,17,17,2,2,2,0,0,1
RS Fernando ,Sri Lanka,2023,2023,1,1,2,2,2,0,0,2
NJ Ferraby ,JER,2019,2021,18,18,2,2,2,0,0,1
D Ferreira ,South Africa,2023,2024,4,4,2,2,2,0,0,1
SP Fleming ,New Zealand,2005,2006,5,5,2,2,2,0,0,1
DR Flynn ,New Zealand,2008,2012,5,5,2,2,2,0,0,1
M Fontaine ,HUN,2021,2024,11,11,2,2,2,0,0,1
D Foxcroft ,New Zealand,2023,2024,5,4,2,2,2,0,0,2
G Ganbold ,MNG,2024,2024,13,13,2,2,2,0,0,1
CJ Gannon ,United States of America,2019,2019,4,4,2,2,2,0,0,2
LR Gaonkar ,PAN,2023,2023,4,4,2,1,0,1,1,1
JWW Gardner ,Papau New Guinea,2023,2024,6,6,2,2,2,0,0,1
S Gasteratos ,GRC,2021,2021,4,4,2,2,2,0,0,1
Gaurav Tiwari ,INA,2024,2024,10,10,2,2,2,0,0,1
Ghulam Abbas Butt ,FIN,2024,2024,8,8,2,2,2,0,0,1
K Gilham ,CZK-R,2020,2021,7,7,2,2,2,0,0,1
M Gogev ,BUL,2024,2024,7,7,2,2,2,0,0,1
R Goodwin ,PHI,2019,2022,9,9,2,2,2,0,0,1
J Grassi ,ITA,2021,2021,6,6,2,2,2,0,0,1
CJ Green ,Australia,2023,2023,1,1,2,2,2,0,0,2
S Guruvayoorappan ,Mex,2023,2024,7,7,2,0,0,0,2,1
A Halbhavi ,LUX,2021,2023,16,16,2,2,2,0,0,1
Hammad Azam ,Pakistan,2012,2013,5,5,2,2,2,0,0,1
Hammad Mirza ,OMA,2024,2024,4,4,2,1,0,1,1,2
Jandu Hamoud ,KUW,2019,2019,6,6,2,2,2,0,0,1
AS Hansra ,Canada,2012,2013,8,8,2,2,2,0,0,1
Haroon Mughal ,MLT,2019,2021,15,15,2,2,2,0,0,1
LHB Harrington-Myers ,CAY,2019,2022,9,9,2,2,2,0,0,2
E Hasahya ,UGA,2022,2022,5,5,2,2,2,0,0,1
Haseeb Amjad ,Hong Kong,2014,2016,18,18,2,2,2,0,0,1
JW Hastings ,Australia,2010,2016,9,9,2,2,2,0,0,1
C Hauptfleisch ,CAY,2019,2019,5,5,2,1,0,1,1,1
Hein Zin Aung ,MYAN,2024,2024,4,4,2,2,2,0,0,1
T Hewa ,CAY,2023,2023,3,3,2,2,2,0,0,1
R Heyns ,LUX,2020,2020,2,2,2,2,2,0,0,2
C Hinze ,Japan,2024,2024,19,19,2,2,2,0,0,1
RM Hira ,New Zealand,2012,2013,15,15,2,2,2,0,0,1
Hirenkumar Patel ,Chile,2019,2019,4,4,2,2,2,0,0,1
KC Hodsoll ,BER,2008,2021,4,4,2,2,2,0,0,1
Z Hoque ,THA,2019,2020,7,7,2,2,2,0,0,1
T Horpinitch ,SEY,2024,2024,4,4,2,2,2,0,0,2
J Horrocks ,GIBR,2023,2024,15,15,2,2,2,0,0,1
J Hurley ,Arg,2019,2021,7,7,2,2,2,0,0,1
AN Hyobeom ,SKOR,2022,2024,6,6,2,2,2,0,0,1
Izaz Ali ,SVN,2024,2024,6,6,2,2,2,0,0,2
Ikbal Hossain ,Fran,2024,2024,3,3,2,2,2,0,0,1
Imran Ali ,KUW,2019,2019,4,4,2,2,2,0,0,2
Imran Ameer ,MLT,2022,2023,19,19,2,2,2,0,0,1
Imran Arif ,KSA,2021,2021,4,4,2,2,2,0,0,1
CA Ingram ,South Africa,2010,2012,9,9,2,2,2,0,0,1
Irfan Ahmed ,Hong Kong,2014,2015,8,8,2,2,2,0,0,1
Irshad Mubbashar ,KSA,2022,2022,5,5,2,2,2,0,0,1
B Isaac ,STHEL,2022,2024,8,7,2,2,2,0,0,1
O Isesele ,NGA,2021,2021,5,5,2,2,2,0,0,1
Ismat Ullah ,BRA,2019,2019,4,4,2,2,2,0,0,1
Israr Khan ,GER,2021,2021,2,2,2,2,2,0,0,2
Itibarshah Deedar ,Aut,2022,2024,10,10,2,2,2,0,0,1
B Ivanov ,BUL,2019,2024,11,10,2,2,2,0,0,2
DF Jacobs ,THA,2019,2024,9,9,2,2,2,0,0,1
V Jagannivasan ,CZK-R,2021,2022,7,7,2,2,2,0,0,1
Jaison Jerome ,MLT,2022,2023,9,9,2,2,2,0,0,1
YYM Jakda ,LES,2021,2022,13,13,2,2,2,0,0,1
Jassim Khan ,QAT,2023,2023,8,8,2,2,2,0,0,1
Jitin Singh ,TAN,2021,2023,24,24,2,2,2,0,0,2
Joginder Sharma ,India,2007,2007,4,4,2,2,2,0,0,1
NR Johns-Wickberg ,SRB,2021,2023,19,18,2,2,2,0,0,1
GO Jones ,England,2005,2006,2,2,2,2,0,2,0,1
MBS Jonkman ,NED,2010,2010,3,3,2,2,2,0,0,2
Jun Hyunwoo ,SKOR,2022,2024,10,10,2,2,2,0,0,2
DC Jurel ,India,2024,2024,2,2,2,1,0,1,1,1
T Kahamker ,ISR,2022,2024,6,6,2,2,2,0,0,1
MO Kain ,United States of America,2021,2022,7,7,2,2,2,0,0,2
UT Kaisala ,Samoa,2022,2023,8,8,2,1,0,1,1,1
A Kalasi ,THA,2023,2024,11,11,2,2,2,0,0,1
S Kamate ,Mali,2022,2024,15,14,2,2,2,0,0,1
Karweng NG ,PHI,2019,2019,4,4,2,2,2,0,0,2
MS Kasprowicz ,Australia,2005,2005,2,2,2,2,2,0,0,1
LP Kasturiarachchige ,Aut,2021,2021,5,5,2,2,2,0,0,1
SM Katich ,Australia,2005,2006,3,3,2,2,2,0,0,1
Kawsar Khan ,BRA,2024,2024,1,1,2,2,2,0,0,2
Z Khan ,India,2006,2012,17,17,2,2,2,0,0,1
D Khanal ,NEP,2024,2024,3,3,2,2,2,0,0,2
Khurram Khan ,United Arab Emirates,2014,2014,3,3,2,2,2,0,0,1
VJ Kingma ,NED,2016,2024,25,25,2,2,2,0,0,2
M Klinger ,Australia,2017,2017,3,3,2,2,2,0,0,1
M Koli ,ROM,2022,2024,21,21,2,2,2,0,0,1
P Kotoisuva ,Fiji,2023,2024,10,10,2,2,2,0,0,2
A Krishna ,SGP,2019,2023,18,18,2,2,2,0,0,1
HGJM Kulatunga ,Sri Lanka,2008,2008,2,2,2,2,2,0,0,2
Akhil Kumar ,Canada,2024,2024,6,6,2,2,2,0,0,2
CBRLS Kumara ,Sri Lanka,2019,2023,26,25,2,2,2,0,0,1
M Kyriacou ,CYP,2021,2021,6,6,2,2,2,0,0,1
AN Lascu ,ROM,2024,2024,4,4,2,2,2,0,0,1
LC Le Tissier ,GUE,2019,2023,20,20,2,2,2,0,0,2
B Schuster ,Samoa,2022,2022,2,2,2,2,2,0,0,2
S Loday ,BHU,2022,2024,14,14,2,2,2,0,0,1
DB Loic ,CAM,2021,2024,21,21,2,2,2,0,0,1
D Long Martinez ,ESP,2024,2024,2,2,2,2,2,0,0,2
TSS Mackintosh ,Scotland,2023,2023,2,2,2,2,0,2,0,2
M Magagula (SWA/SWZ),NA,2021,2024,25,24,2,2,2,0,0,1
MF Maharoof ,Sri Lanka,2006,2016,8,8,2,2,2,0,0,1
S Mahmood ,England,2019,2024,18,17,2,2,2,0,0,1
Mahmudul Hasan Joy ,BAN,2023,2023,3,3,2,2,2,0,0,2
ML Maiava ,Samoa,2023,2023,3,3,2,2,2,0,0,1
NA Maiolo ,ITA,2019,2019,8,7,2,2,2,0,0,1
D Manani ,ROM,2019,2021,3,3,2,2,2,0,0,2
MF Manjate ,MOZ,2023,2024,7,7,2,2,2,0,0,1
Mansoor Amjad ,Pakistan,2008,2008,1,1,2,2,2,0,0,2
V Marghashayam ,CZK-R,2023,2023,2,2,2,2,2,0,0,1
M Mariyappan ,SEY,2024,2024,3,3,2,2,2,0,0,2
D Marsic ,CRT,2022,2024,9,9,2,2,2,0,0,1
A Martin ,West Indies,2011,2011,1,1,2,2,2,0,0,2
SW Masakadza ,Zimbabwe,2010,2013,7,7,2,2,2,0,0,1
WT Mashinge ,Zimbabwe,2019,2019,2,2,2,2,2,0,0,2
B Mavuta ,Zimbabwe,2018,2024,13,13,2,2,2,0,0,1
Mazharul Islam ,SEY,2021,2024,18,17,2,2,1,1,0,1
K Mendon ,CZK-R,2019,2021,17,17,2,2,2,0,0,1
Merwais Shinwari ,SVN,2024,2024,6,6,2,2,2,0,0,1
Milad Momend ,LUX,2023,2024,6,6,2,2,2,0,0,1
NO Miller ,West Indies,2009,2014,9,9,2,2,2,0,0,1
TS Mills (ENG/ICC),NA,2016,2023,16,16,2,2,2,0,0,1
SF Mire ,Zimbabwe,2018,2019,9,9,2,2,2,0,0,1
RP Mitchell ,Bhm,2021,2021,5,5,2,2,2,0,0,1
JQK Moala ,Fiji,2024,2024,6,6,2,2,2,0,0,1
SJ Modani ,United States of America,2021,2022,5,5,2,2,2,0,0,1
A Modi ,SGP,2022,2022,7,7,2,2,2,0,0,2
K Modise ,BOT,2019,2023,7,7,2,2,2,0,0,1
Mohammad Salman ,Pakistan,2011,2011,1,1,2,1,0,1,1,2
Mohammed Asghar ,KUW,2019,2019,4,4,2,2,2,0,0,1
Mohammed Nurji ,MWest Indies,2019,2019,6,6,2,2,2,0,0,1
RS Morton ,West Indies,2006,2010,7,7,2,2,2,0,0,1
JWN Moses ,BOT,2019,2021,7,7,2,2,2,0,0,1
FJ Mpegna ,CAM,2021,2024,12,12,2,2,2,0,0,2
Muhammad Burhan ,HUN,2024,2024,4,4,2,2,2,0,0,2
Muhammad Farooq ,United Arab Emirates,2024,2024,8,8,2,2,2,0,0,1
Muhammad Khan ,Hong Kong,2023,2023,6,6,2,2,0,2,0,1
Muhammad Nadeem ,KSA,2019,2019,5,5,2,2,2,0,0,2
Muhammad Saleem ,BRA,2019,2024,5,5,2,2,2,0,0,1
Mukesh Kumar ,India,2023,2024,17,17,2,2,2,0,0,1
Mukhtar Ahmed ,Pakistan,2015,2015,6,6,2,2,2,0,0,1
SR Mukkamalla ,United States of America,2024,2024,9,9,2,2,2,0,0,1
J Mulder ,Ireland,2016,2017,8,8,2,2,2,0,0,1
D Mullen ,GUE,2023,2024,10,10,2,2,2,0,0,2
LF Muller ,BRA,2024,2024,1,1,2,2,2,0,0,2
Munim Shahriar ,BAN,2022,2022,5,4,2,2,2,0,0,1
G Murali ,CRC,2019,2024,8,8,2,2,0,2,0,1
Murat Ipek ,TKY,2023,2023,4,3,2,2,2,0,0,2
Murat Yilmaz ,TKY,2023,2023,3,3,2,2,2,0,0,1
T Musekiwa ,Zimbabwe,2024,2024,5,5,2,2,2,0,0,1
A Mustafa ,Arg,2021,2023,2,2,2,2,2,0,0,2
CT Mutombodzi ,Zimbabwe,2013,2020,15,15,2,2,2,0,0,1
Myat Thu Aung ,MYAN,2023,2024,9,9,2,2,2,0,0,2
Naeem Islam ,BAN,2008,2013,10,10,2,2,2,0,0,1
B Namsrai ,MNG,2023,2024,13,13,2,2,0,2,0,2
Nanda Kumar ,CRC,2019,2019,3,3,2,2,2,0,0,2
Naved-ul-Hasan ,Pakistan,2006,2010,4,4,2,2,2,0,0,1
Nawazish Jezuli ,KSA,2019,2019,1,1,2,2,0,2,0,2
Nazmul Islam ,BAN,2018,2018,13,13,2,2,2,0,0,1
P Negi ,India,2016,2016,1,1,2,2,2,0,0,2
JD Newton ,CRT,2022,2022,4,4,2,2,2,0,0,1
SF Nhavotso ,MOZ,2021,2021,4,4,2,2,2,0,0,1
H Niaz ,Fran,2024,2024,10,10,2,2,2,0,0,1
G Nikitas ,GRC,2019,2019,2,2,2,0,0,0,2,2
I Niyomugabo ,RWN,2024,2024,2,2,2,2,2,0,0,2
Noah Mead ,Samoa,2024,2024,6,6,2,2,2,0,0,1
Noor Momand ,Belg,2019,2019,2,2,2,2,0,2,0,1
M Ntini ,South Africa,2005,2011,10,10,2,2,2,0,0,1
VM Nyauchi ,Zimbabwe,2022,2022,2,2,2,2,2,0,0,1
GH O'Brien ,BER,2008,2019,11,11,2,2,2,0,0,1
MH Oman ,SVN,2022,2022,4,4,2,2,2,0,0,1
CB Ondoa ,CAM,2021,2022,11,11,2,2,0,2,0,1
A Osei ,GHA,2022,2024,17,17,2,1,1,0,1,1
E Otieno ,Kenya,2012,2022,31,31,2,2,2,0,0,1
KO Otieno ,Kenya,2008,2008,4,4,2,2,2,0,0,1
Ousman Bah ,GMB,2022,2024,11,11,2,2,0,2,0,1
HC Overdijk ,NED,2018,2019,4,3,2,2,2,0,0,2
AM Oyede ,NGA,2019,2019,8,8,2,2,2,0,0,2
E Packard ,GIBR,2019,2021,8,8,2,2,2,0,0,1
J Pakhiaokajee ,THA,2022,2022,6,6,2,2,2,0,0,1
RJG Palmer ,JER,2019,2023,10,10,2,2,2,0,0,1
T Panyangara ,Zimbabwe,2013,2016,14,14,2,2,2,0,0,1
Pargat Singh ,Canada,2022,2024,19,19,2,2,2,0,0,1
SD Parry ,England,2014,2015,5,5,2,2,2,0,0,2
Parveen Kumar ,Canada,2024,2024,8,7,2,2,2,0,0,1
Parvez Hossain Emon ,BAN,2022,2024,6,6,2,2,2,0,0,1
AAA Patel ,LES,2021,2022,8,8,2,2,2,0,0,1
IK Pathan ,India,2006,2012,24,23,2,2,2,0,0,1
M Pathirana ,Sri Lanka,2022,2024,17,17,2,2,2,0,0,1
C Pengkumta ,THA,2019,2024,26,26,2,2,2,0,0,1
K Pierre ,West Indies,2018,2020,10,10,2,2,2,0,0,1
S Pitabeddara ,SKOR,2024,2024,3,3,2,2,2,0,0,1
OL Pitcher ,BER,2008,2008,3,3,2,2,2,0,0,2
SM Pollock ,South Africa,2005,2008,12,12,2,2,2,0,0,1
NS Poonia ,Scotland,2007,2010,8,7,2,2,2,0,0,1
A Poulose ,OMA,2017,2017,3,3,2,2,2,0,0,1
DBL Powell ,West Indies,2007,2007,5,5,2,2,2,0,0,1
AD Poynter ,Ireland,2012,2016,19,17,2,2,2,0,0,1
Pratis GC ,NEP,2023,2024,10,10,2,2,2,0,0,1
P Pustoslemsek ,SVN,2022,2022,4,4,2,2,2,0,0,1
Qadeer Ahmed ,United Arab Emirates,2015,2019,10,10,2,2,2,0,0,1
Qasim Akram ,Pakistan,2023,2023,3,3,2,2,2,0,0,1
Raees Ahmadzai ,Afghanistan,2010,2010,8,8,2,2,2,0,0,1
Raag Kapur ,Hong Kong,2019,2023,7,7,2,2,2,0,0,1
Rahat Ali ,CZK-R,2023,2024,6,6,2,2,2,0,0,1
Rahel Khan ,SWE,2021,2021,7,7,2,2,2,0,0,1
AM Rajpurohit ,GMB,2024,2024,3,3,2,2,2,0,0,1
Rakibul Hasan ,BAN,2023,2023,3,3,2,2,2,0,0,2
S Rakshit ,CZK-R,2019,2019,6,6,2,2,2,0,0,1
R Rampaul ,West Indies,2007,2021,27,27,2,2,2,0,0,1
Hamza Khan ,RWN,2023,2024,26,26,2,2,2,0,0,1
Rasheed Ali Mamadkhel ,SVN,2024,2024,6,6,2,2,2,0,0,1
Rayhaan Ahmed ,Aut,2021,2021,4,4,2,1,0,1,1,1
Raza-ur-Rehman ,Canada,2012,2013,5,5,2,2,2,0,0,1
Raza Hasan ,Pakistan,2012,2014,10,10,2,2,2,0,0,1
DJ Reekers ,NED,2008,2009,6,5,2,2,2,0,0,1
GA Reynold ,Blz,2019,2019,3,3,2,2,2,0,0,2
CR Richards ,STHEL,2022,2024,8,7,2,1,0,1,1,1
DL Richards ,STHEL,2022,2022,5,4,2,2,2,0,0,1
D Robson ,EST,2023,2024,13,13,2,2,2,0,0,1
KTK Rodrigo ,MDV,2023,2024,13,13,2,2,2,0,0,1
CB Roposo ,MOZ,2022,2024,17,17,2,2,2,0,0,1
Sachin Kumar ,BHR,2022,2024,13,13,2,2,2,0,0,1
P Sadev ,ITA,2022,2022,4,4,2,2,0,2,0,2
S Saeed ,MDV,2019,2019,5,5,2,2,2,0,0,2
Saeed Waqar Ali ,SVN,2024,2024,5,5,2,2,2,0,0,1
Sagar Pun ,NEP,2014,2015,9,9,2,2,2,0,0,1
Sajid Khan Afridi ,GRC,2024,2024,4,4,2,2,2,0,0,1
J Salazar ,Peru,2019,2019,2,2,2,2,2,0,0,1
S Samal ,RWN,2021,2021,8,8,2,2,2,0,0,2
Samader Shadab ,GRC,2024,2024,4,4,2,2,2,0,0,2
Sami Ullah ,ROM,2020,2021,9,9,2,2,2,0,0,2
AJA Samuels ,COK,2024,2024,6,6,2,2,2,0,0,1
L Sanogo ,Mali,2022,2024,15,14,2,2,2,0,0,1
Saqib Zulfiqar ,NED,2018,2024,7,7,2,2,2,0,0,2
M Sarenac ,SRB,2019,2024,27,26,2,2,2,0,0,1
A Sarma ,GER,2019,2021,5,5,2,2,2,0,0,1
H Satheedevi ,CRT,2024,2024,4,4,2,2,2,0,0,1
A Sathya ,Mex,2019,2019,3,3,2,2,2,0,0,1
BV Save ,MAS,2020,2020,2,2,2,2,2,0,0,2
J Sebanja ,UGA,2021,2023,9,9,2,2,2,0,0,1
Sediqullah Atal ,Afghanistan,2023,2024,6,6,2,2,2,0,0,1
V Sehwag ,India,2006,2012,19,18,2,2,2,0,0,1
L Shafeeg ,MDV,2019,2024,25,25,2,2,2,0,0,1
Shah Abrar Hussain ,CAM,2023,2024,9,8,2,2,2,0,0,1
Shahab Alam ,NEP,2021,2022,6,6,2,2,2,0,0,1
Shahidullah ,Afghanistan,2023,2023,3,2,2,2,2,0,0,2
Shaikh Ashraf ,Peru,2019,2019,4,4,2,2,2,0,0,2
Shakeel Ansar ,Pakistan,2012,2012,2,2,2,1,0,1,1,2
PH Shamdasani ,Peru,2019,2019,4,4,2,2,2,0,0,1
Shamsullah Ehsan ,TKY,2022,2024,8,8,2,2,2,0,0,2
Shamsur Rahman ,BAN,2013,2014,9,8,2,2,2,0,0,1
V Shankar ,India,2018,2019,9,9,2,2,2,0,0,1
Shariz Ahmad ,NED,2022,2024,11,11,2,2,2,0,0,1
P Sharma ,Kenya,2022,2024,18,17,2,2,2,0,0,1
Sherul Mehta ,Belg,2020,2021,3,3,2,2,0,2,0,2
Shoaib Ahmed ,CYP,2022,2022,5,5,2,2,2,0,0,1
Shoaib Akhtar ,Pakistan,2006,2010,15,15,2,2,2,0,0,1
Shoaib Ali ,KSA,2019,2020,8,8,2,2,2,0,0,2
Shoaib Qureshi ,FIN,2019,2019,5,5,2,2,2,0,0,1
WA Simpson ,SGP,2024,2024,6,6,2,2,2,0,0,1
RP Singh ,India,2007,2009,10,9,2,2,2,0,0,1
Siraj Ullah Khadem ,PORT,2021,2024,23,23,2,2,2,0,0,2
R Siriwardena ,CYP,2024,2024,9,9,2,2,2,0,0,1
S Snater ,NED,2018,2019,13,12,2,2,2,0,0,1
Sohag Gazi ,BAN,2012,2015,10,10,2,2,2,0,0,1
Sohel Patel ,PAN,2023,2023,4,4,2,2,2,0,0,2
S Sola ,Samoa,2019,2022,10,10,2,2,2,0,0,2
LI Salomone ,MOZ,2022,2024,14,14,2,2,2,0,0,1
M Spoors ,Canada,2022,2022,10,10,2,2,2,0,0,1
S Sreesanth ,India,2006,2008,10,9,2,2,2,0,0,2
JH Stander ,Scotland,2009,2012,11,11,2,2,2,0,0,1
J Stanigze ,SWE,2024,2024,2,2,2,2,2,0,0,1
S Stanikzay ,Fran,2024,2024,9,9,2,2,2,0,0,1
CAH Stevenson ,United States of America,2022,2022,4,4,2,2,2,0,0,1
GM Strydom ,CAY,2019,2019,6,6,2,2,2,0,0,1
Sumit Singh ,FIN,2023,2023,2,2,2,2,2,0,0,2
K Suttisan ,THA,2019,2023,4,4,2,2,2,0,0,2
Syed Naqvi ,ITA,2023,2024,4,4,2,2,2,0,0,2
Syed Rehmatullah ,MAS,2022,2022,7,6,2,2,0,2,0,1
Tahir Dar ,BHR,2019,2019,4,4,2,2,2,0,0,1
Tarun Sharma ,Mex,2019,2023,10,10,2,2,1,1,0,1
DR Tawake ,Fiji,2024,2024,6,6,2,2,2,0,0,1
P Taylor ,CZK-R,2019,2021,11,11,2,2,2,0,0,1
VE Tembo ,MOZ,2019,2024,26,25,2,1,1,0,1,1
G Thakur ,MLT,2023,2024,13,13,2,2,2,0,0,1
WU Tharanga ,Sri Lanka,2006,2018,26,26,2,2,2,0,0,1
TO Thilappan ,SGP,2023,2023,3,3,2,2,2,0,0,1
O Thomas ,West Indies,2018,2023,21,20,2,2,2,0,0,1
RA Thomas ,Canada,2019,2019,8,8,2,2,2,0,0,1
GJ Thompson ,Ireland,2016,2019,10,10,2,2,2,0,0,1
T Thushara ,Sri Lanka,2008,2010,6,6,2,2,2,0,0,1
SF Tiai ,Samoa,2019,2024,16,16,2,2,2,0,0,1
BM Tickner ,New Zealand,2019,2023,18,18,2,2,2,0,0,1
MK Tiwary ,India,2011,2012,3,3,2,2,2,0,0,2
JC Tredwell ,England,2012,2014,17,16,2,2,2,0,0,1
ME Trescothick ,England,2005,2006,3,3,2,2,2,0,0,2
A Tripathi ,Mex,2019,2024,8,8,2,2,2,0,0,1
RJ Trott ,BER,2008,2021,21,21,2,2,2,0,0,1
CP Turkich ,CRT,2022,2024,9,9,2,2,2,0,0,2
S Udhayan ,SEY,2021,2022,10,9,2,2,2,0,0,1
R Ulutuna ,TKY,2019,2019,4,4,2,2,0,2,0,2
Umran Malik ,India,2022,2023,8,8,2,2,2,0,0,1
H Upadhyay ,MNG,2024,2024,5,5,2,2,2,0,0,2
Usama Mir ,Pakistan,2024,2024,5,5,2,2,2,0,0,1
RV Uthappa ,India,2007,2015,13,12,2,2,1,1,0,1
Uzair Amir ,QAT,2023,2023,2,2,2,2,2,0,0,1
VM Vaghela ,United States of America,2021,2022,2,2,2,2,2,0,0,2
R van der Merwe ,Arg,2019,2019,5,5,2,2,2,0,0,1
M Vandrasi ,CZK-R,2024,2024,4,4,2,2,2,0,0,2
GJ van Rensburg ,Namibia,2024,2024,4,4,2,2,2,0,0,2
Vinod Kumar ,ESP,2019,2020,4,4,2,2,2,0,0,2
BA Viraliliu ,VAN,2023,2024,3,3,2,2,2,0,0,2
BV Vitori ,Zimbabwe,2012,2016,11,11,2,2,2,0,0,1
A Busing-Volschenk ,Namibia,2024,2024,1,1,2,2,2,0,0,2
JM Vujnovich ,CRT,2022,2024,9,9,2,2,2,0,0,2
Waheed Ahmed ,United Arab Emirates,2019,2020,15,15,2,2,2,0,0,1
Waqar Ul Hassan ,KSA,2023,2024,10,10,2,2,2,0,0,1
Waqar Khan ,SVN,2022,2024,7,7,2,2,2,0,0,1
Waqas Haider ,SWE,2022,2022,3,3,2,2,2,0,0,1
DKD Warnakulasuriya ,ITA,2021,2024,9,9,2,2,2,0,0,1
D Wheatley ,Bhm,2022,2023,9,9,2,2,2,0,0,1
S Weleilakeba ,Fiji,2022,2022,3,3,2,2,2,0,0,2
DN Wellalage ,Sri Lanka,2024,2024,4,4,2,2,2,0,0,1
SR Welsh ,Canada,2008,2008,1,1,2,2,2,0,0,2
J West ,GIBR,2023,2023,4,4,2,2,2,0,0,1
M Whelan ,GIBR,2022,2024,13,13,2,2,2,0,0,2
AR White ,Ireland,2008,2012,18,17,2,2,2,0,0,1
OR Willis ,CAY,2019,2023,8,8,2,1,1,0,1,1
Yasar Haroon ,BRA,2019,2024,5,5,2,2,2,0,0,1
Yasir Mehmood ,CYP,2021,2021,4,4,2,2,2,0,0,2
P Yevugah ,GHA,2023,2024,6,6,2,2,2,0,0,1
Zahid Abbas ,Kenya,2021,2021,4,3,2,2,2,0,0,1
Zaker Taqawi ,SWE,2022,2024,16,16,2,2,2,0,0,1
V Zanko ,CRT,2023,2024,7,6,2,2,2,0,0,2
Zhao Tianle ,CHN,2023,2024,7,7,2,2,2,0,0,1
C Zhuwao ,Zimbabwe,2008,2018,7,7,2,2,2,0,0,1
Zishan Shah ,DEN,2019,2019,6,4,2,2,2,0,0,1
Zohaib Sarwar ,PORT,2019,2023,14,14,2,2,2,0,0,2
Zong Yuechao ,CHN,2023,2024,8,8,2,2,2,0,0,2
B Zuiderent ,NED,2009,2010,6,6,2,2,2,0,0,1
CC Machado ,BRA,2024,2024,1,1,1,1,0,1,0,1
Aakash Chand ,NEP,2024,2024,3,3,1,1,1,0,0,1
Aamer Jamal ,Pakistan,2022,2024,6,6,1,1,1,0,0,1
P Abanda ,CAM,2021,2022,13,13,1,1,1,0,0,1
Abdullah Shahid ,MDV,2022,2022,3,3,1,1,1,0,0,1
Abdullah Sheikh ,NOR,2019,2022,5,5,1,1,1,0,0,1
Abdul Naser Baluch ,SWE,2023,2024,8,8,1,1,1,0,0,1
Abdul Rahman ,Fran,2022,2022,1,1,1,1,1,0,0,1
Abdul Samad ,Japan,2024,2024,4,4,1,1,1,0,0,1
Abdul Shakoor ,United Arab Emirates,2015,2019,6,6,1,0,0,0,1,1
JB Abega ,CAM,2021,2024,21,21,1,1,1,0,0,1
Abhilash Patil ,Mex,2024,2024,1,1,1,1,1,0,0,1
M Aboagye ,GHA,2019,2024,14,14,1,1,1,0,0,1
Abraash Khan ,Canada,2019,2019,7,7,1,1,1,0,0,1
Absar Khan ,DEN,2021,2021,2,2,1,1,1,0,0,1
Abu Jayed ,BAN,2018,2018,3,3,1,1,1,0,0,1
GR Adair ,Ireland,2023,2024,10,10,1,1,1,0,0,1
AR Adams ,New Zealand,2005,2006,4,4,1,1,1,0,0,1
BP Adapaka ,HUN,2022,2023,17,16,1,1,1,0,0,1
Aftab Hussain ,Hong Kong,2020,2022,10,10,1,1,1,0,0,1
Agha Salman ,Pakistan,2024,2024,3,3,1,1,1,0,0,1
GJ Agius ,MLT,2019,2019,2,2,1,1,1,0,0,1
P Agnihotri ,NOR,2019,2019,2,2,1,1,1,0,0,1
D Ahir ,PAN,2021,2021,5,5,1,1,1,0,0,1
JKC Ahir ,PAN,2023,2023,3,3,1,1,1,0,0,1
VC Ahir ,PAN,2023,2023,3,3,1,1,1,0,0,1
A Ahmadhel ,BUL,2019,2024,12,11,1,1,1,0,0,1
Ahmadschah Ahmadzai ,GER,2021,2021,1,1,1,1,1,0,0,1
Ahmed Wardak ,GER,2019,2024,13,13,1,1,1,0,0,1
Ahsan Khan ,BUL,2021,2022,12,12,1,1,1,0,0,1
Akash Babu ,QAT,2022,2022,7,7,1,1,1,0,0,1
Akhil Arjunan ,FIN,2023,2024,10,10,1,1,1,0,0,1
Akramullah Malikzada ,HUN,2022,2022,5,4,1,1,1,0,0,1
JDP Albertze ,BER,2023,2023,4,4,1,1,1,0,0,1
GW Aldridge ,New Zealand,2011,2011,1,1,1,1,1,0,0,1
Alexandros Karvelas ,GRC,2022,2022,4,4,1,1,1,0,0,1
Ali Hasan ,ITA,2022,2022,6,6,1,1,1,0,0,1
Ali Hussain ,ROM,2024,2024,5,5,1,1,1,0,0,1
Ali Rasool ,BUL,2024,2024,4,4,1,1,1,0,0,1
Ali Raza ,EST,2021,2022,5,5,1,1,1,0,0,1
GG Alta ,TKY,2022,2024,8,8,1,1,1,0,0,1
YJC Altamirano ,CRC,2024,2024,2,2,1,1,1,0,0,1
M Altankhuyag ,MNG,2023,2023,2,2,1,1,1,0,0,1
RGA Amah ,CAM,2021,2023,17,17,1,1,1,0,0,1
T Amarmend ,MNG,2024,2024,13,13,1,1,1,0,0,1
Amar Naeem ,Aut,2024,2024,8,8,1,1,1,0,0,1
Ameel Mauroof ,MDV,2019,2024,30,30,1,1,1,0,0,1
Ameer Hamzah ,ESP,2023,2023,4,3,1,1,1,0,0,1
AN Aminou ,CAM,2022,2024,17,17,1,1,1,0,0,1
Aminul Islam ,BAN,2019,2021,10,10,1,1,1,0,0,1
Amir Ali ,OMA,2015,2016,10,9,1,1,1,0,0,1
Amir Farooq ,QAT,2024,2024,9,9,1,1,1,0,0,1
Amir Hamza ,Afghanistan,2013,2021,33,33,1,1,1,0,0,1
Amjad Ali ,United Arab Emirates,2014,2015,5,5,1,1,1,0,0,1
Anam Mollik ,ITA,2019,2019,2,2,1,1,1,0,0,1
Ankit Dubey ,SWE,2022,2022,2,2,1,1,1,0,0,1
Anmoldeep Singh ,ITA,2022,2022,4,4,1,1,1,0,0,1
S Arachchige ,ITA,2019,2019,4,4,1,1,1,0,0,1
SSD Arachchige ,Sri Lanka,2023,2023,1,1,1,1,1,0,0,1
VRB Arachchige ,MLT,2024,2024,4,4,1,1,1,0,0,1
SRMJJ Arachchilage ,CYP,2022,2022,4,4,1,1,1,0,0,1
Arafat Sunny ,BAN,2014,2016,10,10,1,1,1,0,0,1
Arshad Mazarzei ,Iran,2020,2020,3,3,1,1,0,1,0,1
Arslan Naseem ,PORT,2021,2021,1,1,1,1,1,0,0,1
Asad Mahmood ,SUI,2021,2023,15,15,1,1,1,0,0,1
Asif Ali ,BHR,2024,2024,5,5,1,1,1,0,0,1
Asif Bevinje ,ROM,2020,2024,10,10,1,1,1,0,0,1
RD Atangana ,CAM,2022,2024,14,14,1,1,1,0,0,1
V Ateak ,GHA,2019,2024,7,7,1,1,1,0,0,1
MS Aulakh ,Canada,2012,2013,3,3,1,1,1,0,0,1
Aviel Warsulkar ,ISR,2024,2024,2,2,1,1,1,0,0,1
Awais Ikram ,SVN,2022,2022,2,2,1,1,1,0,0,1
KM Awala ,GHA,2022,2024,17,17,1,1,1,0,0,1
P Ayoleyine ,GHA,2022,2023,6,6,1,1,1,0,0,1
Azri Azhar ,MAS,2024,2024,2,2,1,1,1,0,0,1
MO Bacarese ,GIBR,2019,2023,4,4,1,1,1,0,0,1
KF Bakiweyem ,GHA,2021,2021,3,3,1,1,1,0,0,1
WD Balaji Rao ,Canada,2008,2008,4,4,1,1,1,0,0,1
B Balala ,MWest Indies,2024,2024,6,6,1,1,1,0,0,1
JT Ball ,England,2018,2018,2,2,1,1,1,0,0,1
CT Bancroft ,Australia,2016,2016,1,1,1,1,0,1,0,1
HMCM Bandara ,Sri Lanka,2006,2009,4,4,1,1,1,0,0,1
S Bangera ,ISR,2022,2024,8,8,1,1,0,1,0,1
S Bantzas ,GRC,2019,2019,1,1,1,1,1,0,0,1
AB Barath ,West Indies,2010,2011,2,2,1,1,1,0,0,1
S Barediya ,SWZ,2023,2023,2,2,1,1,1,0,0,1
LS Barkania ,TAN,2024,2024,5,5,1,1,1,0,0,1
OO Bascome ,BER,2008,2019,3,3,1,1,1,0,0,1
Baseer Khan ,Aut,2024,2024,9,9,1,1,1,0,0,1
Bashar Khan ,ITA,2022,2022,5,5,1,1,1,0,0,1
Basir Ahamad ,NEP,2022,2022,2,2,1,1,1,0,0,1
KA Bazil ,CAY,2022,2023,8,8,1,1,1,0,0,1
L Berthe ,Mali,2022,2024,10,9,1,1,1,0,0,1
A Bhargava ,SGP,2022,2023,5,5,1,1,1,0,0,1
P Bhart ,NOR,2019,2021,10,10,1,1,1,0,0,1
RL Bhudia ,Kenya,2007,2007,3,3,1,1,1,0,0,1
Bilawal Bhatti ,Pakistan,2013,2015,9,9,1,1,1,0,0,1
Bipin Kumar ,QAT,2023,2023,8,8,1,1,1,0,0,1
TR Birt ,Australia,2010,2012,4,4,1,1,1,0,0,1
A Bishnoi ,MLT,2021,2023,12,12,1,1,1,0,0,1
D Bishoo ,West Indies,2011,2019,7,7,1,1,1,0,0,1
JAR Blain ,Scotland,2007,2008,6,5,1,1,1,0,0,1
PD Blignaut ,Namibia,2024,2024,4,4,1,1,1,0,0,1
SM Boland ,Australia,2016,2016,3,3,1,1,1,0,0,1
SG Borthwick ,England,2011,2011,1,1,1,1,1,0,0,1
LE Bosman ,South Africa,2006,2010,14,14,1,1,1,0,0,1
TS Braat ,NED,2019,2021,6,6,1,1,1,0,0,1
IDR Bradshaw ,West Indies,2006,2006,1,1,1,1,1,0,0,1
D Brevis ,South Africa,2023,2023,2,2,1,1,1,0,0,1
DR Briggs ,England,2012,2014,7,6,1,1,1,0,0,1
WC Broaster ,Blz,2021,2021,1,1,1,1,1,0,0,1
N Buckle ,GUE,2019,2019,3,3,1,1,1,0,0,1
DK Butler ,West Indies,2006,2006,1,1,1,1,1,0,0,1
CL Cairns ,New Zealand,2005,2006,2,2,1,1,1,0,0,1
J Cama ,Fiji,2024,2024,5,5,1,1,1,0,0,1
JD Campbell ,West Indies,2019,2019,2,2,1,1,1,0,0,1
RJ Campbell ,Hong Kong,2016,2016,3,3,1,1,1,0,0,1
MA Carberry ,England,2014,2014,1,1,1,1,1,0,0,1
TO Carmichael ,United States of America,2021,2021,2,2,1,1,1,0,0,1
BA Carse ,England,2023,2024,4,4,1,1,1,0,0,1
NM Carter ,Scotland,2013,2013,7,7,1,1,1,0,0,1
C Cassell ,Scotland,2024,2024,1,1,1,1,1,0,0,1
P Chandran ,Mex,2019,2019,3,3,1,1,1,0,0,1
J Chaturanga ,BHR,2022,2022,4,4,1,1,1,0,0,1
S Chaudhary ,CZK-R,2022,2024,7,7,1,1,1,0,0,1
TS Chisoro ,Zimbabwe,2015,2020,14,14,1,1,1,0,0,1
TL Chivanga ,Zimbabwe,2022,2022,3,3,1,1,1,0,0,1
G Chohan ,PHI,2022,2024,14,14,1,1,1,0,0,1
S Chophel ,BHU,2019,2023,5,5,1,0,0,0,1,1
Choudry Share Ali ,SWE,2023,2024,9,9,1,1,1,0,0,1
F Clarke ,IOM,2023,2023,9,8,1,1,1,0,0,1
C Connolly ,Australia,2024,2024,2,2,1,1,1,0,0,1
AN Cook ,England,2007,2009,4,4,1,1,1,0,0,1
JM Cox ,England,2024,2024,2,2,1,1,1,0,0,1
S Crowie ,STHEL,2022,2024,8,7,1,1,1,0,0,1
J Cutinho ,CRC,2019,2019,3,3,1,1,1,0,0,1
DK Dahani ,Iran,2020,2020,3,3,1,1,1,0,0,1
DK Dahyabhai Ahir ,PAN,2019,2019,2,2,1,1,1,0,0,1
JWM Dalrymple ,England,2006,2007,3,3,1,1,1,0,0,1
S Dalton ,CZK-R,2019,2019,2,2,1,1,1,0,0,1
H Dandapani ,FIN,2019,2024,8,8,1,1,1,0,0,1
Danish Jasnaik ,BHR,2022,2022,9,9,1,1,1,0,0,1
Danyal Akbar ,HUN,2024,2024,3,3,1,1,1,0,0,1
JC Darji ,TAN,2021,2022,8,8,1,1,1,0,0,1
IK Darmawan ,INA,2022,2023,3,3,1,1,1,0,0,1
N Davidovic ,CRT,2022,2022,3,3,1,1,1,0,0,1
BJ Davidson ,SRB,2021,2021,4,4,1,1,0,1,0,1
AS Dean ,Canada,2008,2013,2,2,1,1,1,0,0,1
M de Lange ,South Africa,2012,2015,6,6,1,1,1,0,0,1
JL de Mey ,NED,2021,2021,3,3,1,1,1,0,0,1
P Deol ,CYP,2024,2024,3,3,1,1,1,0,0,1
A Desai ,United States of America,2024,2024,1,1,1,1,1,0,0,1
SI de Saram ,Sri Lanka,2009,2009,1,1,1,1,1,0,0,1
PC de Silva ,Sri Lanka,2017,2017,2,2,1,1,1,0,0,1
P Desungnoen ,THA,2022,2024,4,4,1,1,1,0,0,1
D Dewald ,Belg,2024,2024,10,10,1,1,1,0,0,1
SM Dhakal ,NEP,2023,2023,2,2,1,1,1,0,0,1
Dhiman Ghosh ,BAN,2008,2008,1,1,1,0,0,0,1,1
MT Diaby ,Mali,2022,2023,10,9,1,1,1,0,0,1
R Dianish ,MLT,2024,2024,5,5,1,1,1,0,0,1
J Dickinson ,Scotland,2024,2024,1,1,1,1,1,0,0,1
C Dickson ,COK,2022,2024,12,12,1,1,1,0,0,1
SDJJ Dima ,MOZ,2019,2022,15,14,1,1,1,0,0,1
AB Dinda ,India,2009,2012,9,9,1,1,1,0,0,1
JN Dorji ,BHU,2019,2024,9,9,1,1,1,0,0,1
S Draunivudi ,Fiji,2022,2022,3,3,1,1,1,0,0,1
A Dutt ,NED,2021,2024,16,16,1,1,1,0,0,1
G Dutta ,Mex,2019,2019,7,7,1,1,1,0,0,1
BJ Dwarshuis ,Australia,2022,2023,3,3,1,1,1,0,0,1
V Dwivedi ,EST,2022,2022,2,2,1,1,1,0,0,1
D Eckstein ,Aut,2023,2023,1,1,1,1,1,0,0,1
J Edness ,BER,2008,2008,3,3,1,0,0,0,1,1
Emran Shahbakhsh ,Iran,2020,2020,3,3,1,1,1,0,0,1
RMS Eranga ,Sri Lanka,2012,2013,3,3,1,1,1,0,0,1
Eric Phiri ,SWZ,2022,2024,15,14,1,1,1,0,0,1
B Evans ,Zimbabwe,2022,2023,8,8,1,1,1,0,0,1
L Evile ,Samoa,2019,2019,4,4,1,1,1,0,0,1
MTM Faatea ,Samoa,2023,2023,3,3,1,1,1,0,0,1
M Faheem ,THA,2019,2020,7,7,1,1,1,0,0,1
Fakhrul Mohon ,PORT,2019,2022,8,8,1,1,1,0,0,1
M Faraz Akram ,Zimbabwe,2020,2024,9,9,1,1,1,0,0,1
Fareed Shius ,MDV,2023,2023,2,2,1,1,1,0,0,1
Farhan Ahmed ,United Arab Emirates,2016,2016,3,3,1,1,1,0,0,1
Fayyaz Ahmed ,United Arab Emirates,2015,2015,1,1,1,1,1,0,0,1
Fazil Muhammad ,SKOR,2024,2024,5,5,1,1,1,0,0,1
Fazil Rahman ,MLT,2023,2023,6,6,1,1,1,0,0,1
L Fereti ,Samoa,2023,2023,3,3,1,1,1,0,0,1
CJ Ferguson ,Australia,2009,2009,3,3,1,1,1,0,0,1
MNK Fernando ,Sri Lanka,2023,2023,1,1,1,1,1,0,0,1
SE Findlay ,West Indies,2008,2008,2,2,1,1,1,0,0,1
P Florin ,ROM,2019,2021,16,16,1,1,1,0,0,1
BT Foakes ,England,2019,2019,1,1,1,1,0,1,0,1
CR Foggo ,BER,2008,2008,3,3,1,1,1,0,0,1
C Forbes (SWA/SWZ),NA,2021,2023,15,14,1,1,1,0,0,1
C Forshaw ,GUE,2024,2024,8,8,1,1,1,0,0,1
S Franklin ,SUI,2021,2021,2,2,1,1,1,0,0,1
M Fru ,CAM,2021,2021,4,4,1,1,1,0,0,1
C Fry ,LUX,2019,2019,3,3,1,1,1,0,0,1
R Frylinck ,South Africa,2017,2018,3,3,1,1,1,0,0,1
ST Gabriel ,West Indies,2013,2013,2,2,1,1,1,0,0,1
R Galgalikar ,Mex,2024,2024,2,2,1,1,1,0,0,1
D Ganesh ,CRC,2024,2024,5,5,1,1,1,0,0,1
MD Garratt ,GIBR,2019,2021,8,8,1,1,1,0,0,1
Garret Banner ,Blz,2019,2021,7,7,1,1,1,0,0,1
WT Gavera ,Papau New Guinea,2015,2017,6,6,1,1,1,0,0,1
Gershon Yusuf ,NGA,2019,2019,1,1,1,1,1,0,0,1
K Ghalley ,BHU,2023,2023,4,4,1,1,1,0,0,1
P Gheewala ,EST,2023,2024,9,9,1,1,1,0,0,1
O Gholami ,SWE,2021,2021,5,5,1,1,1,0,0,1
S Gill ,Kenya,2024,2024,6,6,1,1,1,0,0,1
MR Gillespie ,New Zealand,2006,2008,11,11,1,1,1,0,0,1
N Gnanapragasam ,SEY,2024,2024,1,1,1,1,1,0,0,1
GF Gomes ,MOZ,2019,2022,15,14,1,1,1,0,0,1
M Goonetilleke ,MLT,2019,2021,3,3,1,1,1,0,0,1
TG Gordon ,Canada,2012,2012,3,3,1,1,1,0,0,1
S Goud ,CZK-R,2019,2019,1,1,1,1,1,0,0,1
M Gouws ,GIBR,2022,2024,13,13,1,1,1,0,0,1
R Gowthaman ,SWE,2021,2021,5,5,1,1,1,0,0,1
MS Graham ,Bhm,2021,2021,6,6,1,1,1,0,0,1
JJ Griffin ,IOM,2023,2023,3,2,1,1,1,0,0,1
M Grzinic ,CRT,2024,2024,3,3,1,1,1,0,0,1
Gurpreet Singh ,ITA,2022,2022,3,3,1,1,1,0,0,1
AM Guruge ,United Arab Emirates,2014,2015,5,5,1,1,1,0,0,1
SP Guzman ,PAN,2021,2021,5,5,1,1,1,0,0,1
T Gwandu ,Zimbabwe,2023,2024,6,6,1,1,1,0,0,1
Hadisullah Tarakhel ,Belg,2021,2021,5,5,1,1,1,0,0,1
Hafez Farooq ,Peru,2019,2019,4,4,1,1,1,0,0,1
JB Hakizimana ,RWN,2022,2022,2,2,1,1,1,0,0,1
Hamed Khan ,Hong Kong,2020,2023,5,5,1,1,1,0,0,1
V Hampihallikar ,SGP,2022,2022,6,6,1,1,1,0,0,1
J Hansrod ,SWA,2021,2021,4,4,1,1,0,1,0,1
Haris Karim ,SVN,2024,2024,1,1,1,1,1,0,0,1
SJ Harmison ,England,2005,2006,2,2,1,1,1,0,0,1
A Harris ,Bhm,2021,2022,6,6,1,1,1,0,0,1
CV Harrison ,GIBR,2021,2021,7,7,1,1,1,0,0,1
Harry Johnson ,GUE,2024,2024,9,9,1,1,1,0,0,1
Haseebullah Khan ,Pakistan,2024,2024,3,3,1,1,1,0,0,1
Hashmatullah Shahidi ,Afghanistan,2013,2022,6,6,1,1,1,0,0,1
Hassan Mehmood ,SWE,2021,2021,5,5,1,1,1,0,0,1
RJ Hatchman ,GIBR,2019,2023,16,16,1,1,1,0,0,1
NM Hauritz ,Australia,2009,2009,3,3,1,1,1,0,0,1
ML Hayden ,Australia,2005,2007,9,9,1,1,1,0,0,1
PD Hennessy ,ESP,2019,2021,13,13,1,1,1,0,0,1
J Henry ,STHEL,2022,2022,7,6,1,1,1,0,0,1
JAM Henri ,PORT,2024,2024,5,5,1,1,1,0,0,1
Het Patel ,SWZ,2024,2024,3,3,1,1,1,0,0,1
WW Hinds ,West Indies,2006,2010,5,5,1,1,1,0,0,1
GB Hogg ,Australia,2006,2014,15,15,1,1,1,0,0,1
IG Holland ,United States of America,2021,2021,6,6,1,1,1,0,0,1
JM How ,New Zealand,2007,2008,5,5,1,1,1,0,0,1
MJ Humphreys ,Ireland,2023,2024,3,3,1,1,1,0,0,1
MG Hunter ,GIBR,2019,2019,4,4,1,1,1,0,0,1
Husnain Kabeer ,GER,2021,2021,1,1,1,1,0,1,0,1
Hussain Saadhin ,MDV,2023,2023,2,2,1,1,1,0,0,1
AA Hussein ,TAN,2022,2022,2,2,1,1,1,0,0,1
Lee Hwanhee ,SKOR,2022,2022,2,2,1,1,1,0,0,1
GM Hyde ,Blz,2019,2019,3,3,1,1,1,0,0,1
Ikramullah Khan ,QAT,2022,2024,13,13,1,1,1,0,0,1
Ilyas Ahmed ,KUW,2019,2024,19,19,1,1,1,0,0,1
Imran Ahmed Kaneez ,CRC,2024,2024,5,5,1,1,1,0,0,1
Imran Ashraf ,QAT,2019,2020,4,4,1,1,1,0,0,1
Imran Butt ,BHR,2020,2020,4,4,1,1,1,0,0,1
Imran Haider ,United Arab Emirates,2016,2019,11,11,1,1,1,0,0,1
Imran Yousaf ,KSA,2020,2024,11,11,1,1,1,0,0,1
PJ Ingram ,New Zealand,2010,2010,3,3,1,1,1,0,0,1
Asif Iqbal ,SKOR,2022,2022,3,3,1,1,1,0,0,1
Irfan Hafejee ,PAN,2021,2023,10,10,1,1,1,0,0,1
Irfan Khan ,Pakistan,2024,2024,6,6,1,1,1,0,0,1
Irfan Sarfraz ,KSA,2022,2022,4,4,1,1,1,0,0,1
H Isorena ,PHI,2022,2023,5,5,1,1,1,0,0,1
Ivan Splicevic ,CRT,2023,2023,2,2,1,1,0,1,0,1
Izhar Hussain ,SUI,2023,2023,4,4,1,1,1,0,0,1
KA Jadhav ,CAM,2022,2023,6,6,1,1,1,0,0,1
KM Jadhav ,India,2015,2017,9,9,1,1,1,0,0,1
Jakob Gul ,BUL,2024,2024,2,2,1,1,0,1,0,1
J Jarvis ,Scotland,2024,2024,5,5,1,1,1,0,0,1
Jaswinder Singh ,MLT,2023,2024,6,6,1,1,1,0,0,1
M Jenkinson ,FIN,2022,2023,5,5,1,1,1,0,0,1
B Jerkovic ,CRT,2022,2024,9,9,1,1,1,0,0,1
K Jethi ,Canada,2008,2008,5,5,1,1,1,0,0,1
A Johnmary ,Fran,2021,2021,2,2,1,1,1,0,0,1
D Johnson ,CAY,2022,2023,6,6,1,1,1,0,0,1
NG Jones ,Ireland,2010,2012,5,4,1,1,1,0,0,1
C Jonker ,South Africa,2018,2018,2,2,1,1,1,0,0,1
HJ Jordaan ,THA,2019,2020,8,8,1,1,1,0,0,1
RR Joshi ,Canada,2021,2024,7,7,1,1,1,0,0,1
K Juma ,TAN,2024,2024,4,4,1,1,1,0,0,1
Junaid Khan ,PORT,2021,2024,20,20,1,1,1,0,0,1
Junaid Siddique ,BAN,2007,2012,7,7,1,1,1,0,0,1
A Kadowaki Fleming ,Japan,2024,2024,3,3,1,1,1,0,0,1
A Kainessie ,Sri LankaE,2023,2024,9,9,1,1,1,0,0,1
Kaleem Shah ,MOZ,2019,2019,7,6,1,1,1,0,0,1
R Kalimuthu ,SGP,2023,2024,14,14,1,1,1,0,0,1
D Kalvin ,SEY,2021,2022,11,11,1,1,1,0,0,1
Kamal Raiz ,CYP,2024,2024,1,1,1,1,1,0,0,1
JK Kamande ,Kenya,2007,2010,12,12,1,1,1,0,0,1
I Kamara ,Sri LankaE,2022,2023,11,11,1,1,1,0,0,1
Kamran Shazad ,United Arab Emirates,2014,2014,3,3,1,1,1,0,0,1
TS Kamunhukamwe ,Zimbabwe,2020,2024,15,15,1,1,1,0,0,1
ST Kanakalil ,MLT,2020,2020,3,3,1,1,1,0,0,1
TE Kane ,Ireland,2015,2023,9,7,1,1,1,0,0,1
SS Kang ,United Arab Emirates,2024,2024,3,3,1,1,1,0,0,1
A Kapoor ,Canada,2022,2022,2,2,1,1,1,0,0,1
Karma Dorji ,BHU,2023,2024,12,12,1,1,1,0,0,1
K Kekez ,CRT,2024,2024,3,3,1,1,1,0,0,1
S Keshvani ,Canada,2010,2010,2,2,1,1,1,0,0,1
RWT Key ,England,2009,2009,1,1,1,1,1,0,0,1
B Kgosiemang ,BOT,2022,2024,7,7,1,1,1,0,0,1
Khalid Kail ,OMA,2024,2024,21,21,1,1,1,0,0,1
V Khanduri ,CYP,2024,2024,4,4,1,1,1,0,0,1
R Khanyapa ,LES,2024,2024,5,5,1,1,1,0,0,1
N Khosla ,MLT,2019,2019,4,4,1,1,1,0,0,1
Khurram Chohan ,Canada,2010,2010,4,4,1,1,1,0,0,1
Khurram Shahzad ,QAT,2020,2020,7,7,1,1,1,0,0,1
JH Kiani ,PHI,2019,2023,5,5,1,1,1,0,0,1
TCR Kimber ,GUE,2019,2019,3,3,1,0,0,0,1,1
S Kimura ,Japan,2022,2023,5,5,1,1,1,0,0,1
H Kinga ,CAM,2024,2024,3,3,1,1,1,0,0,1
H Klazinge ,Namibia,2023,2024,6,6,1,1,1,0,0,1
K Klein ,NED,2024,2024,8,8,1,1,1,0,0,1
RK Kleinveldt ,South Africa,2008,2013,6,6,1,1,1,0,0,1
W Kokaua ,COK,2022,2022,5,5,1,1,1,0,0,1
ML Kostic ,SRB,2022,2022,9,9,1,1,1,0,0,1
M Kristensen ,DEN,2023,2023,2,2,1,1,1,0,0,1
PE Kruger ,South Africa,2024,2024,7,7,1,1,1,0,0,1
K Kubota ,Japan,2022,2024,16,16,1,1,1,0,0,1
Kuldeep Singh ,PHI,2019,2019,4,4,1,1,1,0,0,1
P Kumar ,India,2008,2012,10,10,1,1,1,0,0,1
BLCS Kumara ,CYP,2021,2021,2,2,1,1,1,0,0,1
M Labuschagne ,Australia,2022,2022,1,1,1,1,1,0,0,1
D la Cock ,Namibia,2022,2022,5,5,1,1,1,0,0,1
A Lagos ,GRC,2019,2019,1,1,1,1,1,0,0,1
CK Langeveldt ,South Africa,2005,2010,9,9,1,1,1,0,0,1
B Laughlin ,Australia,2009,2013,3,3,1,1,1,0,0,1
Lee Kangmin ,SKOR,2022,2024,6,6,1,1,1,0,0,1
DO Leicher ,Namibia,2022,2024,13,13,1,1,1,0,0,1
AR Leo ,STHEL,2022,2024,8,7,1,1,1,0,0,1
LJ Leokaoke ,LES,2024,2024,8,8,1,1,1,0,0,1
J Lewis ,England,2005,2007,2,2,1,1,1,0,0,1
ML Lewis ,Australia,2006,2006,2,2,1,1,1,0,0,1
RN Lewis ,West Indies,2008,2008,1,1,1,1,1,0,0,1
ZB Lion-Cachet ,NED,2024,2024,4,4,1,1,1,0,0,1
J Liyanage ,Sri Lanka,2022,2022,3,3,1,1,1,0,0,1
NCK Liyanage ,MAS,2019,2019,6,5,1,1,1,0,0,1
KS Lokuarachchi ,Sri Lanka,2012,2012,2,2,1,1,1,0,0,1
J Long ,PHI,2019,2019,2,2,1,1,1,0,0,1
Luca Petre ,ROM,2023,2024,6,6,1,1,1,0,0,1
Luke Ward ,IOM,2023,2024,5,5,1,1,1,0,0,1
Mabsar Abdulla ,MDV,2024,2024,2,2,1,1,1,0,0,1
GD McGrath ,Australia,2005,2005,2,2,1,1,1,0,0,1
M Machado ,PORT,2023,2023,8,8,1,1,1,0,0,1
NJ Maddinson ,Australia,2013,2018,6,6,1,1,1,0,0,1
DL Maddy ,England,2007,2007,4,4,1,1,1,0,0,1
HAG Madhushanka ,SEY,2024,2024,2,2,1,1,1,0,0,1
SKDT Madusanka ,SEY,2021,2024,18,17,1,1,1,0,0,1
SSB Magala ,South Africa,2021,2023,6,6,1,1,1,0,0,1
Mahmad Data ,PAN,2019,2023,4,4,1,1,1,0,0,1
SI Mahmood ,England,2006,2009,4,4,1,1,1,0,0,1
GI Maiden ,Scotland,2008,2008,3,3,1,1,1,0,0,1
Maidul Islam ,EST,2021,2022,12,12,1,1,1,0,0,1
BF Mailata ,Samoa,2019,2019,4,4,1,1,1,0,0,1
A Makesh ,KUW,2019,2019,4,4,1,1,1,0,0,1
M Malle ,Mali,2022,2024,10,9,1,1,1,0,0,1
Manan Bashir ,BUL,2024,2024,3,3,1,1,1,0,0,1
AK Mandal ,NEP,2015,2015,2,2,1,1,1,0,0,1
Mandeep Singh ,India,2016,2016,3,3,1,1,1,0,0,1
Manish Sharma ,CAM,2023,2024,10,9,1,1,1,0,0,1
Mansoor Malangzai ,Belg,2024,2024,4,4,1,1,1,0,0,1
KT Maphaka ,South Africa,2024,2024,3,3,1,1,1,0,0,1
D Marks ,MLT,2019,2023,6,6,1,1,1,0,0,1
HJH Marshall ,New Zealand,2005,2006,3,3,1,1,1,0,0,1
OM Marshall ,Peru,2019,2019,3,3,1,1,1,0,0,1
DE Martel ,GUE,2022,2024,6,6,1,1,1,0,0,1
CS Martin ,New Zealand,2007,2008,6,6,1,1,1,0,0,1
M Martin ,SUI,2021,2021,1,1,1,1,1,0,0,1
DR Martyn ,Australia,2005,2006,4,4,1,1,1,0,0,1
DK Mathias ,BHR,2022,2022,16,16,1,1,1,0,0,1
GE Mathurin ,West Indies,2011,2012,3,3,1,1,1,0,0,1
MV Matsau ,LES,2021,2024,14,14,1,1,1,0,0,1
D Mauro ,Arg,2023,2023,4,4,1,1,1,0,0,1
CE McConchie ,New Zealand,2021,2024,12,11,1,1,1,0,0,1
M Meade ,Chile,2019,2019,1,1,1,1,1,0,0,1
SC Meaker ,England,2012,2012,2,2,1,1,1,0,0,1
A Mehmood ,Hong Kong,2016,2024,7,7,1,1,1,0,0,1
KD Mehta ,CZK-R,2021,2021,3,3,1,1,1,0,0,1
RTM Mendis ,Sri Lanka,2021,2024,4,4,1,1,1,0,0,1
AB Mengoumou ,CAM,2021,2022,8,8,1,1,1,0,0,1
CAJ Meschede ,GER,2019,2019,5,5,1,1,1,0,0,1
KO Meth ,Zimbabwe,2012,2012,2,2,1,1,1,0,0,1
Michael Charlie ,Papau New Guinea,2023,2023,2,2,1,1,1,0,0,1
G Miller ,COK,2022,2022,2,2,1,0,0,0,1,1
Mirza Ahmed ,KUW,2023,2024,3,3,1,1,1,0,0,1
Mirza Baig ,Pakistan,2023,2023,3,3,1,1,1,0,0,1
A Mishra ,India,2010,2017,10,10,1,1,1,0,0,1
Mohamed Coulibaly ,Mali,2022,2024,13,12,1,1,1,0,0,1
Mohamed Ishmath ,MDV,2024,2024,8,8,1,1,1,0,0,1
Mohamed Miuvaan ,MDV,2023,2024,4,4,1,1,1,0,0,1
Mohammad Asaduzzaman ,FIN,2022,2022,9,9,1,1,1,0,0,1
Mohammad Hasnain ,Pakistan,2019,2022,27,27,1,1,1,0,0,1
Mohammad Irfan ,Pakistan,2012,2019,22,22,1,1,1,0,0,1
Mohammad Ishaq ,Afghanistan,2024,2024,4,4,1,1,0,1,0,1
Mohammad Kashif ,NED,2010,2010,3,3,1,1,1,0,0,1
Mohammad Shahzad ,United Arab Emirates,2015,2017,20,20,1,1,1,0,0,1
Mohammad Tauqir ,United Arab Emirates,2015,2015,3,3,1,1,1,0,0,1
Mohammad Waheed ,Hong Kong,2023,2023,1,1,1,1,1,0,0,1
Mohammad Yasin ,ESP,2022,2024,12,11,1,1,1,0,0,1
Mohammad Yousuf ,Pakistan,2006,2010,3,3,1,1,1,0,0,1
JN Mohammed ,West Indies,2017,2018,9,9,1,1,1,0,0,1
Mohammed Faraazuddin ,United Arab Emirates,2023,2023,6,6,1,1,1,0,0,1
Mohammed Qasim ,United Arab Emirates,2016,2017,3,3,1,1,1,0,0,1
Mohammed Shami ,India,2014,2022,23,23,1,1,1,0,0,1
HJC Mol ,NED,2008,2008,4,3,1,1,1,0,0,1
Mominul Haque ,BAN,2012,2014,6,6,1,1,1,0,0,1
L Monanthane ,LES,2021,2024,11,11,1,1,1,0,0,1
D Mongia ,India,2006,2006,1,1,1,1,1,0,0,1
Mrittunjoy Chowdhury ,BAN,2023,2023,1,1,1,1,1,0,0,1
G Mubiru ,UGA,2021,2021,3,3,1,1,1,0,0,1
I Mugisha ,RWN,2023,2024,7,7,1,1,1,0,0,1
Muhammad Afis ,INA,2022,2023,4,4,1,1,1,0,0,1
Muhammad Amin (SWA/SWZ),NA,2021,2024,10,10,1,1,1,0,0,1
Muhammad Asjed ,ESP,2019,2021,3,3,1,1,1,0,0,1
Muhammad Imran ,FIN,2022,2022,1,1,1,1,1,0,0,1
Muhammad Kaleem ,United Arab Emirates,2016,2016,9,9,1,1,1,0,0,1
Muhammad Khurram ,MWest Indies,2019,2019,5,5,1,1,0,1,0,1
Muhammad Naeem ,KSA,2019,2020,7,7,1,1,1,0,0,1
Muhammad Saqib ,KSA,2022,2022,5,5,1,1,1,0,0,1
Muhammed Manga ,GMB,2022,2024,11,11,1,1,0,1,0,1
Muhammet Bicer ,TKY,2023,2024,6,5,1,1,1,0,0,1
EMDY Munaweera ,Sri Lanka,2012,2017,13,13,1,1,1,0,0,1
Munir Dar ,Hong Kong,2014,2014,2,2,1,1,1,0,0,1
M Muralidaran ,Sri Lanka,2006,2010,12,12,1,1,1,0,0,1
S Murari ,CRC,2019,2024,8,8,1,1,1,0,0,1
D Murphy ,Scotland,2013,2013,4,4,1,1,0,1,0,1
Murtaza Yamin ,CYP,2021,2021,1,1,1,1,1,0,0,1
N M'shangwe ,Zimbabwe,2013,2014,5,5,1,1,1,0,0,1
Mustafa Omer ,Fran,2021,2021,1,1,1,1,1,0,0,1
Mustapha Suwareh ,GMB,2022,2024,11,11,1,1,1,0,0,1
T Muzarabani ,Zimbabwe,2015,2016,9,9,1,1,1,0,0,1
M Mwamadi ,MWest Indies,2019,2022,12,12,1,1,1,0,0,1
AR Naidoo ,CAY,2023,2023,4,4,1,1,1,0,0,1
L Nakomo ,MWest Indies,2021,2021,6,6,1,1,1,0,0,1
Nangeyalia Kharote ,Afghanistan,2024,2024,6,6,1,1,1,0,0,1
DP Nannes (AUS/NED),NA,2009,2010,17,17,1,1,1,0,0,1
WSLK Narayana ,ISR,2024,2024,4,4,1,1,1,0,0,1
Naseem Khan ,CRT,2022,2023,8,7,1,1,1,0,0,1
SM Nash ,Samoa,2024,2024,6,6,1,1,1,0,0,1
D Nath ,NEP,2022,2022,4,4,1,0,0,0,1,1
S Natsagdorj ,MNG,2024,2024,4,4,1,1,1,0,0,1
Naveed Fakhr ,KUW,2020,2021,3,3,1,1,1,0,0,1
Naveed Shahid ,FIN,2021,2022,6,6,1,1,1,0,0,1
Nay Lin Htun ,MYAN,2023,2024,9,9,1,1,1,0,0,1
Nazakat Ali ,NOR,2019,2019,2,2,1,1,1,0,0,1
N Ndouteng ,CAM,2021,2023,5,5,1,1,1,0,0,1
P Nedeljkovic ,SRB,2023,2024,6,6,1,1,1,0,0,1
A Nel ,South Africa,2005,2007,2,2,1,1,1,0,0,1
JD Nel ,Scotland,2007,2010,10,9,1,1,1,0,0,1
Nijat Masood ,Afghanistan,2022,2022,3,3,1,1,1,0,0,1
R Nil ,SEY,2021,2021,4,4,1,1,1,0,0,1
Nilansh Keswani ,United Arab Emirates,2023,2024,10,10,1,1,1,0,0,1
A Nimaga ,Mali,2024,2024,3,3,1,1,1,0,0,1
PA Nixon ,England,2007,2007,1,1,1,0,0,0,1,1
Nooruddin Mujadady ,GER,2021,2022,6,6,1,1,1,0,0,1
L Nussbaumer ,GUE,2019,2019,1,1,1,1,1,0,0,1
JM Obando ,CRC,2024,2024,1,1,1,1,1,0,0,1
PP Ojha ,India,2009,2010,6,6,1,1,1,0,0,1
SNJ O'Keefe ,Australia,2010,2011,7,7,1,1,1,0,0,1
SO Olayinka ,NGA,2021,2021,3,3,1,1,1,0,0,1
R Olipa ,UGA,2019,2019,2,2,1,1,1,0,0,1
Omair Yousuf ,Pakistan,2023,2023,3,3,1,1,1,0,0,1
Omid Shafi Rahman ,United Arab Emirates,2024,2024,5,5,1,1,1,0,0,1
Omid Rahimi ,Belg,2024,2024,2,2,1,1,0,1,0,1
Osman Khan ,Aut,2022,2022,1,1,1,1,1,0,0,1
SD Outerbridge ,BER,2008,2008,3,3,1,1,1,0,0,1
MAP Ovalle ,Chile,2023,2023,2,2,1,1,0,1,0,1
K Pala ,Papau New Guinea,2015,2015,2,2,1,1,1,0,0,1
I Pandey ,NEP,2019,2019,4,4,1,1,1,0,0,1
MW Parkinson ,England,2019,2022,6,6,1,1,1,0,0,1
HJ Patel ,PAN,2023,2023,2,2,1,1,0,1,0,1
PA Patel ,India,2011,2011,2,2,1,1,0,1,0,1
D Paterson ,South Africa,2017,2018,8,8,1,1,1,0,0,1
WA Peatfield ,GUE,2019,2022,21,21,1,1,1,0,0,1
K Penjor ,BHU,2022,2022,1,1,1,1,1,0,0,1
AK Perera ,Sri Lanka,2013,2019,6,6,1,1,1,0,0,1
SL Perera ,GHA,2019,2019,2,2,1,1,1,0,0,1
WKD Perkins ,West Indies,2008,2008,1,1,1,1,1,0,0,1
J Perman ,ESP,2019,2021,7,7,1,1,1,0,0,1
C Pervez ,Canada,2021,2021,5,5,1,1,1,0,0,1
AN Petersen ,South Africa,2010,2010,2,2,1,1,1,0,0,1
VD Philander ,South Africa,2007,2007,7,7,1,1,1,0,0,1
R Pillai ,GER,2019,2019,6,6,1,1,1,0,0,1
P Pirabakaran ,Fran,2023,2023,3,3,1,1,1,0,0,1
R Pisal ,ROM,2019,2019,1,1,1,1,1,0,0,1
JS Pita ,Samoa,2023,2023,3,3,1,1,1,0,0,1
S Pokhriyal ,CZK-R,2019,2020,9,9,1,1,1,0,0,1
LW Potthoff ,CRT,2024,2024,2,2,1,1,1,0,0,1
KOA Powell ,West Indies,2014,2014,1,1,1,1,1,0,0,1
GY Prastama ,INA,2023,2023,4,4,1,1,1,0,0,1
AEV Puentes ,Chile,2023,2023,2,2,1,1,1,0,0,1
M Pushpakumara ,Sri Lanka,2009,2009,1,1,1,1,1,0,0,1
Qudratullah Mir Afzail ,SWE,2021,2021,6,6,1,1,1,0,0,1
Moshiur Rahman ,EST,2021,2022,4,4,1,1,1,0,0,1
M Raikes ,GIBR,2024,2024,2,2,1,1,1,0,0,1
CAK Rajitha ,Sri Lanka,2016,2023,18,18,1,1,1,0,0,1
A Rajshekara ,ROM,2024,2024,8,8,1,1,1,0,0,1
S Ramakrishnan ,CZK-R,2022,2022,6,6,1,1,1,0,0,1
Ramandeep Singh ,India,2024,2024,2,2,1,1,1,0,0,1
Ramanjot Singh ,SVN,2022,2024,5,5,1,1,1,0,0,1
A Rangaswamy ,BOT,2019,2021,8,8,1,1,1,0,0,1
Raqibul Hasan ,BAN,2008,2010,5,5,1,1,1,0,0,1
PV Rarotoga ,Samoa,2023,2023,3,3,1,1,1,0,0,1
Rashid Hashmi ,CRT,2024,2024,1,1,1,1,0,1,0,1
KB Ahir ,PAN,2019,2023,15,15,1,1,1,0,0,1
Ravinder Singh ,MLT,2019,2021,7,7,1,1,1,0,0,1
D Rawat ,CRC,2024,2024,5,5,1,1,1,0,0,1
CMW Read ,England,2006,2006,1,1,1,1,0,1,0,1
FL Reifer ,West Indies,2009,2009,1,1,1,1,1,0,0,1
JB Reva ,Papau New Guinea,2015,2019,9,9,1,1,1,0,0,1
JDA Richardson ,BER,2023,2023,3,3,1,1,1,0,0,1
KAJ Roach ,West Indies,2008,2012,11,11,1,1,1,0,0,1
DE Roache ,Samoa,2022,2024,9,9,1,1,1,0,0,1
Robiul Khan ,ESP,2023,2023,1,1,1,1,1,0,0,1
IH Romaine ,BER,2008,2008,2,2,1,1,1,0,0,1
Rubel Hossain ,BAN,2009,2021,28,27,1,1,1,0,0,1
Rumman Raees ,Pakistan,2016,2018,8,8,1,1,1,0,0,1
RJMGM Rupasinghe ,Sri Lanka,2009,2009,2,2,1,1,1,0,0,1
HD Rutherford ,New Zealand,2013,2019,8,8,1,1,1,0,0,1
Saad Nasim ,Pakistan,2014,2014,3,3,1,1,1,0,0,1
VM Sachdev ,PAN,2019,2019,2,2,1,1,1,0,0,1
Sadeeq Khan ,ROM,2019,2019,3,3,1,1,1,0,0,1
Saghar Manzoor ,CRT,2024,2024,5,5,1,1,1,0,0,1
Said Hakim ,Belg,2021,2024,3,3,1,1,1,0,0,1
Saif Ullah Malik ,MAS,2024,2024,1,1,1,1,1,0,0,1
Saif Hassan ,BAN,2021,2023,5,5,1,1,1,0,0,1
Sajad Ahmadzai ,Belg,2022,2024,17,17,1,1,1,0,0,1
Sajedul Islam ,BAN,2013,2013,1,1,1,1,1,0,0,1
AM Samad ,Canada,2008,2010,7,7,1,1,1,0,0,1
Samiallah Khalil ,SWE,2022,2022,2,2,1,1,1,0,0,1
T Sangha ,Australia,2023,2023,7,7,1,1,1,0,0,1
JRMVB Sanjaya ,Sri Lanka,2017,2017,8,8,1,1,1,0,0,1
K Santokie ,West Indies,2011,2014,12,12,1,1,1,0,0,1
Saqlain Ali ,Belg,2019,2021,6,6,1,1,1,0,0,1
Saqlain Arshad ,QAT,2019,2024,23,23,1,1,1,0,0,1
Sarfaraj Patel ,LES,2021,2021,6,6,1,1,1,0,0,1
MM Sarwar ,KUW,2019,2021,7,7,1,1,1,0,0,1
I Sawmy ,DEN,2019,2019,2,2,1,1,1,0,0,1
Sayed Shirzad ,Afghanistan,2015,2019,4,4,1,1,1,0,0,1
Sazzad Hosen ,Belg,2020,2024,8,8,1,1,1,0,0,1
G Schachat ,ISR,2022,2022,3,3,1,1,1,0,0,1
CP Schofield ,England,2007,2007,4,4,1,1,1,0,0,1
BV Sears ,New Zealand,2021,2024,17,15,1,1,1,0,0,1
S Sengupta ,CZK-R,2021,2022,9,9,1,1,1,0,0,1
Shadnan Khan ,Aut,2024,2024,5,5,1,1,1,0,0,1
Shaffeq Muhammad ,GRC,2019,2019,2,2,1,1,1,0,0,1
Shafiul Islam ,BAN,2010,2020,20,20,1,1,1,0,0,1
Shahid Afridi ,GER,2023,2023,7,7,1,1,1,0,0,1
Shahnawaz Dahani ,Pakistan,2021,2022,11,11,1,1,1,0,0,1
Shahriar Nafees ,BAN,2006,2006,1,1,1,1,1,0,0,1
A Shahzad ,England,2010,2011,3,3,1,1,1,0,0,1
SP Shalders ,Chile,2023,2023,2,2,1,1,1,0,0,1
Shamsudheen Purat ,KSA,2019,2020,6,6,1,1,1,0,0,1
JNK Shannon ,Ireland,2013,2018,8,8,1,1,1,0,0,1
Shaof Hassan ,MDV,2023,2024,12,12,1,1,1,0,0,1
KK Sharma ,SVN,2024,2024,2,2,1,1,1,0,0,1
MM Sharma ,India,2014,2015,8,8,1,1,1,0,0,1
PP Shaw ,India,2021,2021,1,1,1,1,1,0,0,1
Shehzad Patel (SWA/SWZ),NA,2021,2023,9,9,1,1,0,1,0,1
R Sheshadri ,SGP,2024,2024,4,4,1,1,1,0,0,1
V Shetty ,United Arab Emirates,2014,2014,2,2,1,1,1,0,0,1
SPS Shikongo ,Namibia,2024,2024,4,4,1,1,1,0,0,1
Shoaib Khan jnr ,Pakistan,2008,2008,4,4,1,1,1,0,0,1
S Shrivastava ,OMA,2022,2024,9,9,1,1,1,0,0,1
Shunan Ali ,MDV,2022,2024,10,10,1,1,1,0,0,1
Shuvagata Hom ,BAN,2016,2016,5,5,1,1,1,0,0,1
B Siddharth ,OMA,2024,2024,2,2,1,1,1,0,0,1
EHSN Silva ,United Arab Emirates,2014,2014,2,2,1,1,1,0,0,1
KRP Silva ,United States of America,2019,2019,2,2,1,1,1,0,0,1
BA Simango ,MOZ,2019,2022,4,4,1,1,1,0,0,1
A Simelane ,South Africa,2024,2024,4,4,1,1,1,0,0,1
A Bhadauria ,LUX,2022,2022,2,2,1,1,1,0,0,1
Sivakumar ,CAM,2023,2023,6,5,1,1,1,0,0,1
DS Smith ,West Indies,2007,2009,6,6,1,1,1,0,0,1
JF Smith ,South Africa,2024,2024,1,1,1,1,1,0,0,1
SJS Smith ,Scotland,2010,2012,5,5,1,0,0,0,1,1
J Smits ,NED,2008,2009,6,5,1,1,0,1,0,1
JT Smuts ,South Africa,2017,2021,13,13,1,1,1,0,0,1
JN Snape ,England,2007,2007,1,1,1,1,1,0,0,1
GJ Snyman ,South Africa,2021,2021,1,1,1,1,1,0,0,1
U Sofi ,Samoa,2022,2022,3,3,1,1,1,0,0,1
M Sohel Patel ,PAN,2019,2023,15,15,1,1,1,0,0,1
Soochan Park ,SKOR,2022,2022,2,2,1,1,1,0,0,1
GO Sopinho ,MOZ,2021,2021,1,1,1,1,1,0,0,1
S Srikanth ,SGP,2022,2022,1,1,1,1,0,1,0,1
A Srivastav ,Chile,2019,2019,4,4,1,1,1,0,0,1
M Stanikzai ,SUI,2024,2024,3,3,1,1,1,0,0,1
ADL Stokoe ,IOM,2021,2021,4,4,1,1,1,0,0,1
AJ Strauss ,England,2005,2009,4,4,1,1,1,0,0,1
R Strydom ,Ireland,2008,2008,4,3,1,1,1,0,0,1
Sufiyan Muqeem ,Pakistan,2023,2024,5,5,1,1,1,0,0,1
Sukhkaran Sahi ,ROM,2022,2023,5,5,1,1,1,0,0,1
TE Sumiya ,MNG,2023,2024,6,6,1,1,1,0,0,1
P Syafiq Ali ,MAS,2019,2019,2,1,1,1,1,0,0,1
Syed Rasel ,BAN,2007,2008,8,8,1,1,1,0,0,1
Syed Tameem ,QAT,2022,2022,1,1,1,1,1,0,0,1
Taher Muhammad ,SVN,2022,2024,10,10,1,1,1,0,0,1
Tanveer Ahmed ,Hong Kong,2016,2017,5,5,1,1,1,0,0,1
Tanvir Islam ,BAN,2023,2024,4,4,1,1,1,0,0,1
Tashi Phuntsho ,BHU,2023,2024,9,9,1,1,1,0,0,1
K Tathgur ,Canada,2024,2024,2,2,1,1,1,0,0,1
OE Taylor ,COK,2024,2024,6,6,1,1,1,0,0,1
Tayyab Tahir ,Pakistan,2023,2023,3,3,1,1,1,0,0,1
D Teinaki ,COK,2022,2022,4,4,1,1,1,0,0,1
SR Tendulkar ,India,2006,2006,1,1,1,1,1,0,0,1
SP Terry ,Ireland,2016,2016,1,1,1,1,1,0,0,1
MK Thakur ,THA,2024,2024,13,13,1,1,1,0,0,1
T Yotharat ,THA,2022,2022,3,3,1,1,1,0,0,1
VT Thiyanesh ,SGP,2023,2023,1,1,1,1,1,0,0,1
K Thuchila ,MWest Indies,2024,2024,4,4,1,1,1,0,0,1
M Thurgate ,Japan,2024,2024,2,2,1,1,0,1,0,1
S Tobgay ,BHU,2019,2019,2,2,1,1,1,0,0,1
GC Tonge ,West Indies,2009,2009,1,1,1,1,1,0,0,1
Toqeer Ahmad ,DEN,2024,2024,6,6,1,1,1,0,0,1
O Touray ,GMB,2022,2022,3,3,1,1,1,0,0,1
D Traore ,Mali,2022,2023,7,6,1,1,0,1,0,1
LL Tsotsobe ,South Africa,2009,2014,23,23,1,1,1,0,0,1
JJ Tucker ,BER,2019,2019,5,5,1,1,1,0,0,1
T Tumursukh ,MNG,2023,2024,10,10,1,1,1,0,0,1
JL Tutty ,COK,2024,2024,6,6,1,1,1,0,0,1
B Tuyizere ,RWN,2021,2023,13,13,1,1,1,0,0,1
S Tyagi ,India,2009,2009,1,1,1,1,1,0,0,1
Ubaid Martuza ,BHR,2024,2024,2,2,1,1,1,0,0,1
I Uboh ,NGA,2024,2024,3,3,1,1,1,0,0,1
W Uisuk ,THA,2020,2020,4,4,1,1,1,0,0,1
NL Ujawe ,SVN,2022,2022,4,4,1,1,1,0,0,1
A Uniyal ,Chile,2019,2023,5,5,1,1,1,0,0,1
Usama Master ,MWest Indies,2019,2019,6,6,1,1,1,0,0,1
Usman Ali ,KSA,2019,2020,8,8,1,1,1,0,0,1
Usman Limbada ,Canada,2010,2013,7,7,1,1,1,0,0,1
Usman Shinwari ,Pakistan,2013,2019,16,16,1,1,1,0,0,1
Usman Waheed ,KUW,2019,2019,6,6,1,1,1,0,0,1
B Vakatini ,COK,2022,2022,5,5,1,1,1,0,0,1
PJ van Biljon ,South Africa,2020,2021,10,10,1,1,1,0,0,1
JDF Vandersay ,Sri Lanka,2015,2022,14,14,1,1,1,0,0,1
MB van Schelven ,NED,2015,2015,2,2,1,1,1,0,0,1
CV Varun ,India,2021,2024,13,13,1,1,1,0,0,1
S Vasilakis ,GRC,2024,2024,4,4,1,1,1,0,0,1
TCW Veillard ,GUE,2019,2019,4,4,1,1,1,0,0,1
S Vijayakumar ,SGP,2019,2019,9,9,1,1,1,0,0,1
Vimal Kumar ,PHI,2019,2022,4,4,1,1,1,0,0,1
R Vinay Kumar ,India,2010,2013,9,9,1,1,1,0,0,1
Vinay Iyer ,Japan,2022,2022,2,2,1,1,1,0,0,1
L Vincent ,New Zealand,2006,2007,9,9,1,1,1,0,0,1
W Viraliliu ,VAN,2019,2019,10,10,1,1,1,0,0,1
H Virdee ,LUX,2023,2023,1,1,1,1,1,0,0,1
Virk Ali ,Fran,2021,2021,4,4,1,1,1,0,0,1
Vishal Ahir ,PAN,2019,2019,1,1,1,1,1,0,0,1
KDK Vithanage ,Sri Lanka,2014,2016,3,3,1,1,1,0,0,1
DS Vosloo ,MLT,2021,2021,2,2,1,1,1,0,0,1
D Wabwire ,UGA,2023,2023,7,7,1,1,1,0,0,1
Wahidullah Usmani ,Belg,2020,2021,7,7,1,1,1,0,0,1
Waleed Waqar ,BUL,2024,2024,2,2,1,1,1,0,0,1
Waqar Abbasi ,ROM,2020,2021,3,3,1,1,1,0,0,1
Waqar Khan ,Peru,2019,2019,4,4,1,1,1,0,0,1
S Waqas Ahmed ,NOR,2019,2021,10,10,1,1,1,0,0,1
Waqas Ali ,Belg,2019,2024,7,7,1,1,1,0,0,1
Waqas Khan ,Hong Kong,2014,2020,16,16,1,1,1,0,0,1
VS Wategaonkar ,OMA,2016,2016,2,2,1,1,1,0,0,1
RM West ,Ireland,2009,2009,5,5,1,1,1,0,0,1
AA Westphal ,Mex,2019,2019,5,5,1,1,1,0,0,1
BM Wheeler ,New Zealand,2017,2018,6,6,1,1,1,0,0,1
C Wickramasinghe ,Sri Lanka,2024,2024,2,2,1,1,1,0,0,1
GPK Wijesingha ,MDV,2024,2024,6,6,1,1,1,0,0,1
JD Wildermuth ,Australia,2018,2018,2,2,1,1,1,0,0,1
S Williams ,Sri LankaE,2021,2022,11,11,1,1,1,0,0,1
L Wood ,England,2022,2023,5,5,1,1,1,0,0,1
LJ Woodcock ,New Zealand,2010,2011,3,3,1,1,1,0,0,1
GH Worker ,New Zealand,2015,2015,2,2,1,1,1,0,0,1
M Worndl ,CZK-R,2024,2024,5,5,1,1,1,0,0,1
A Wright ,CAY,2023,2023,4,4,1,1,1,0,0,1
AS Wright ,GUE,2019,2019,8,8,1,1,1,0,0,1
CM Wright ,Scotland,2007,2009,3,2,1,1,1,0,0,1
JJ Wright (SWA/SWZ),NA,2021,2024,6,6,1,1,1,0,0,1
Yadwinder Singh ,HUN,2023,2023,1,1,1,1,1,0,0,1
K Yamamoto-Lake ,Japan,2024,2024,4,4,1,1,1,0,0,1
Yasar Idrees ,KUW,2019,2019,1,1,1,1,1,0,0,1
Yash Singh ,MLT,2023,2023,6,6,1,1,1,0,0,1
Yasir Arafat ,Pakistan,2007,2012,13,13,1,1,1,0,0,1
Yves Cyusa ,RWN,2024,2024,15,15,1,1,1,0,0,1
Zaheer Maqsood ,United Arab Emirates,2015,2016,3,3,1,1,1,0,0,1
Zaheer Zahiri ,Fran,2024,2024,8,8,1,1,1,0,0,1
Zahid Hussain ,Canada,2012,2012,3,3,1,1,1,0,0,1
Zahid Khan ,Sri LankaE,2021,2022,10,10,1,1,1,0,0,1
Zaid Soulat ,BUL,2023,2024,6,5,1,1,1,0,0,1
Zain Ali ,ITA,2024,2024,2,2,1,1,1,0,0,1
Zain Asif ,BUL,2023,2023,4,3,1,1,1,0,0,1
Zakir Hasan ,BAN,2018,2023,4,4,1,1,1,0,0,1
BAA Zammitt ,GIBR,2023,2023,3,3,1,1,1,0,0,1
Zeeshan Abbas ,BHR,2019,2022,4,3,1,1,1,0,0,1
Ziaur Rehman ,FIN,2019,2024,10,10,1,1,1,0,0,1
N Zimonjic ,SRB,2021,2024,20,19,1,1,1,0,0,1
Zoheb Malek ,MLT,2021,2021,1,1,1,1,1,0,0,1
T Zotos ,GRC,2021,2022,7,7,1,1,1,0,0,1
Zou Kui ,CHN,2023,2024,7,7,1,1,1,0,0,1
Zulfiqar Babar ,Pakistan,2013,2014,7,7,1,1,1,0,0,1
Zulqarnain Haider ,Pakistan,2007,2010,3,3,1,0,0,0,1,1
Zulqarnain Haider ,ESP,2019,2022,11,11,1,1,1,0,0,1
L Zulu (SWA/SWZ),NA,2021,2022,6,6,1,1,0,1,0,1
ME Sanuth ,OMA,2020,2020,1,1,0,0,0,0,0,0
RGD Mitchell ,PHI,2023,2023,1,1,0,0,0,0,0,0
Aamer Ikram ,PORT,2019,2019,4,4,0,0,0,0,0,0
Aamer Yamin ,Pakistan,2015,2018,2,2,0,0,0,0,0,0
Aamir Lal ,SKOR,2022,2024,10,10,0,0,0,0,0,0
Aarnav Patel ,Kenya,2024,2024,2,2,0,0,0,0,0,0
Z Abbasi ,BOT,2019,2022,4,4,0,0,0,0,0,0
Abbas Saad ,KSA,2019,2019,2,2,0,0,0,0,0,0
Abdul Hai Muhammad ,Belg,2024,2024,3,3,0,0,0,0,0,0
YA Abdulla ,South Africa,2009,2009,2,2,0,0,0,0,0,0
Abdullah Jasat ,PAN,2021,2023,10,10,0,0,0,0,0,0
Abdullah Rana ,SUI,2023,2024,8,8,0,0,0,0,0,0
Abdulla Bhoola ,PAN,2023,2023,2,2,0,0,0,0,0,0
Abdulla Popalzae ,GRC,2022,2022,1,1,0,0,0,0,0,0
Abdulmalik Jabarkhel ,Fran,2022,2022,2,2,0,0,0,0,0,0
Abdul Bashir ,GER,2023,2023,1,1,0,0,0,0,0,0
Abdul Majid Malik ,BHR,2020,2024,9,9,0,0,0,0,0,0
Abdul Rahman ,Aut,2019,2019,3,3,0,0,0,0,0,0
Abdul Rashid ,Belg,2019,2021,2,2,0,0,0,0,0,0
Abdur Rauf ,Pakistan,2008,2008,1,1,0,0,0,0,0,0
P Abhijit ,SEY,2022,2022,3,2,0,0,0,0,0,0
Abrar Ahmed ,Pakistan,2024,2024,3,3,0,0,0,0,0,0
Abul Hasan ,BAN,2012,2018,5,5,0,0,0,0,0,0
G Aburto ,Chile,2023,2023,2,2,0,0,0,0,0,0
NJV Aburto ,Chile,2023,2023,1,1,0,0,0,0,0,0
Abu Zar ,SWE,2023,2023,2,2,0,0,0,0,0,0
Adam Khalaf ,MDV,2024,2024,1,1,0,0,0,0,0,0
Adel Kolasangiani ,Iran,2020,2020,1,1,0,0,0,0,0,0
Adil Hanif ,BHR,2019,2019,4,4,0,0,0,0,0,0
Adil Khan ,GER,2024,2024,1,1,0,0,0,0,0,0
Adnan Gondal ,PORT,2024,2024,2,2,0,0,0,0,0,0
Adnan Mufti ,United Arab Emirates,2017,2017,1,1,0,0,0,0,0,0
Adnan Syed ,FIN,2021,2021,2,2,0,0,0,0,0,0
Afif Khattak ,SUI,2023,2023,1,1,0,0,0,0,0,0
Aftab Ahmed (2) ,DEN,2019,2021,4,4,0,0,0,0,0,0
R Agamiire ,UGA,2021,2021,2,2,0,0,0,0,0,0
AB Agarkar ,India,2006,2007,4,3,0,0,0,0,0,0
Ahmadi Ravat ,PAN,2023,2023,2,2,0,0,0,0,0,0
Ahmad Raza ,KSA,2024,2024,2,2,0,0,0,0,0,0
RI Ahmed ,NED,2015,2015,2,2,0,0,0,0,0,0
Ahmed Raid ,MDV,2020,2020,1,1,0,0,0,0,0,0
Ahsan Abbasi ,Hong Kong,2019,2019,6,6,0,0,0,0,0,0
Ahsan Ali ,Pakistan,2020,2020,2,2,0,0,0,0,0,0
Ahsan ul Haq ,KUW,2023,2023,3,3,0,0,0,0,0,0
Ahsan Yousuf ,Aut,2022,2022,3,3,0,0,0,0,0,0
KS Airee ,NEP,2021,2022,10,10,0,0,0,0,0,0
Aizaz Cheema ,Pakistan,2011,2012,5,5,0,0,0,0,0,0
M Akhigbe ,NGA,2024,2024,1,1,0,0,0,0,0,0
NN Akhter ,MLT,2020,2020,3,3,0,0,0,0,0,0
K Akurugoda ,HUN,2022,2022,2,1,0,0,0,0,0,0
C Akyuz ,TKY,2019,2019,1,1,0,0,0,0,0,0
MC Alex ,CIV,2024,2024,1,1,0,0,0,0,0,0
Ali Ivan ,MDV,2019,2019,1,1,0,0,0,0,0,0
Ali Abbas ,KSA,2020,2020,1,1,0,0,0,0,0,0
Ali Farasat ,HUN,2022,2024,17,16,0,0,0,0,0,0
Ali Muaaz ,GRC,2024,2024,4,4,0,0,0,0,0,0
Ali Naqi ,PORT,2019,2019,4,4,0,0,0,0,0,0
Ali Mohammadipour ,Iran,2020,2020,3,3,0,0,0,0,0,0
J Allen ,BRA,2019,2019,2,2,0,0,0,0,0,0
HS Alta ,TKY,2019,2019,4,4,0,0,0,0,0,0
KO Altamirano ,CRC,2024,2024,1,1,0,0,0,0,0,0
Amal Jacob ,HUN,2024,2024,4,4,0,0,0,0,0,0
MHSMS Amaradasa ,MDV,2023,2023,1,1,0,0,0,0,0,0
Aminullah Tanha ,NOR,2022,2022,3,3,0,0,0,0,0,0
Amir Hayat ,United Arab Emirates,2018,2019,4,4,0,0,0,0,0,0
Amir Shahzad ,KSA,2021,2021,1,1,0,0,0,0,0,0
Ammad Uddin ,BHR,2019,2021,12,12,0,0,0,0,0,0
Ammar Khalid ,Canada,2022,2022,7,7,0,0,0,0,0,0
Aanand Pandey ,LUX,2021,2021,3,3,0,0,0,0,0,0
PK Ananya ,GHA,2024,2024,4,4,0,0,0,0,0,0
J Anderson ,Ireland,2015,2015,4,2,0,0,0,0,0,0
Andrey Lilov ,BUL,2021,2021,4,4,0,0,0,0,0,0
A Anemogiannis ,GRC,2019,2019,1,1,0,0,0,0,0,0
G Angeletti ,Arg,2023,2024,3,3,0,0,0,0,0,0
B Angeltti ,Arg,2019,2024,5,5,0,0,0,0,0,0
Anik Ahmed ,ITA,2022,2022,4,4,0,0,0,0,0,0
TM Anker ,COK,2024,2024,1,1,0,0,0,0,0,0
DNA Ankrah ,GHA,2019,2019,4,4,0,0,0,0,0,0
M Ansari ,OMA,2015,2016,11,10,0,0,0,0,0,0
Ansar Iqbal ,NOR,2019,2022,9,9,0,0,0,0,0,0
MA Aponso ,Sri Lanka,2018,2018,3,3,0,0,0,0,0,0
Apon Mustafizur ,SRB,2019,2021,4,4,0,0,0,0,0,0
S Appu ,MLT,2019,2019,4,4,0,0,0,0,0,0
Arafat Minhas ,Pakistan,2023,2023,3,3,0,0,0,0,0,0
S Aravind ,India,2015,2015,1,1,0,0,0,0,0,0
Khan Arbaaz ,LES,2022,2022,2,2,0,0,0,0,0,0
Z Arinaitwe ,UGA,2019,2020,6,6,0,0,0,0,0,0
RP Arnold ,Sri Lanka,2006,2006,1,1,0,0,0,0,0,0
Arsalan Qadir ,Canada,2010,2010,1,1,0,0,0,0,0,0
Arshad Hayat ,CZK-R,2019,2019,7,7,0,0,0,0,0,0
Arshad Iqbal ,Pakistan,2021,2023,3,3,0,0,0,0,0,0
Arslan Ahmed ,PORT,2019,2019,3,3,0,0,0,0,0,0
Asad Ali ,Pakistan,2013,2013,2,2,0,0,0,0,0,0
Ashish Rana ,EST,2021,2022,5,5,0,0,0,0,0,0
A Ashok ,New Zealand,2023,2023,1,1,0,0,0,0,0,0
Ashraful Shuvo ,EST,2021,2021,3,3,0,0,0,0,0,0
Asim Ashraf ,GMB,2024,2024,3,3,0,0,0,0,0,0
Aslam Doria ,PAN,2021,2021,3,3,0,0,0,0,0,0
A Aspiotis ,GRC,2019,2019,3,3,0,0,0,0,0,0
Assad Mehmood ,PORT,2023,2023,2,2,0,0,0,0,0,0
SYS Assegon ,CAM,2024,2024,3,3,0,0,0,0,0,0
MFI Assuncao ,BRA,2024,2024,1,1,0,0,0,0,0,0
Aswad Khan ,BUL,2021,2021,3,3,0,0,0,0,0,0
MS Atapattu ,Sri Lanka,2006,2006,2,2,0,0,0,0,0,0
S Ateak ,GHA,2019,2019,3,3,0,0,0,0,0,0
Atif Ali Khan ,United Arab Emirates,2016,2016,1,1,0,0,0,0,0,0
AAP Atkinson ,England,2023,2023,3,3,0,0,0,0,0,0
SMHH Aung ,MYAN,2024,2024,1,1,0,0,0,0,0,0
Aung Ko Ko ,MYAN,2023,2024,13,13,0,0,0,0,0,0
R Avery ,BRA,2019,2019,4,4,0,0,0,0,0,0
Awais Zia ,Pakistan,2012,2014,5,5,0,0,0,0,0,0
P Awana ,India,2012,2012,2,2,0,0,0,0,0,0
Ayush Ummat ,EST,2021,2021,1,1,0,0,0,0,0,0
Ayyaz Qureshi ,SVN,2022,2022,4,4,0,0,0,0,0,0
EI Azine ,MOZ,2024,2024,1,1,0,0,0,0,0,0
Azin Rafeeg ,MDV,2023,2024,3,3,0,0,0,0,0,0
KMA Aziz ,CIV,2024,2024,1,1,0,0,0,0,0,0
Azmat Ali ,GER,2021,2021,2,2,0,0,0,0,0,0
M Badenhorst ,BOT,2023,2023,5,5,0,0,0,0,0,0
S Badrinath ,India,2011,2011,1,1,0,0,0,0,0,0
LS Baker ,West Indies,2008,2009,3,3,0,0,0,0,0,0
L Balaji ,India,2012,2012,5,5,0,0,0,0,0,0
Baljinder Singh ,ROM,2023,2023,1,1,0,0,0,0,0,0
GS Ballance ,Zimbabwe,2023,2023,1,1,0,0,0,0,0,0
S Banamali ,SGP,2024,2024,5,5,0,0,0,0,0,0
KMC Bandara ,Sri Lanka,2016,2016,1,1,0,0,0,0,0,0
HH Banner ,Blz,2019,2019,3,3,0,0,0,0,0,0
NN Banner ,Blz,2021,2021,2,2,0,0,0,0,0,0
I Bardis ,GRC,2022,2022,2,2,0,0,0,0,0,0
S Barnett ,IOM,2024,2024,2,2,0,0,0,0,0,0
JW Bartlett ,Chile,2023,2023,2,2,0,0,0,0,0,0
MC Bascombe ,West Indies,2011,2011,1,1,0,0,0,0,0,0
Bashir Shah ,DEN,2019,2021,9,9,0,0,0,0,0,0
Basiru Jaye ,GMB,2024,2024,2,2,0,0,0,0,0,0
Bashir Ahmad ,SUI,2024,2024,1,1,0,0,0,0,0,0
TC Bastiampillai ,Canada,2010,2010,2,2,0,0,0,0,0,0
MD Bates ,New Zealand,2012,2012,3,3,0,0,0,0,0,0
T Batjargal ,MNG,2024,2024,2,2,0,0,0,0,0,0
E Batkhuyag ,MNG,2024,2024,4,4,0,0,0,0,0,0
GJ Batty ,England,2009,2009,1,1,0,0,0,0,0,0
D Bau ,Papau New Guinea,2017,2017,1,1,0,0,0,0,0,0
CS Baugh ,West Indies,2008,2012,3,3,0,0,0,0,0,0
C Bayraktar ,TKY,2022,2022,3,3,0,0,0,0,0,0
HK Bennett ,New Zealand,2020,2021,11,11,0,0,0,0,0,0
Ben Jones ,EST,2023,2023,1,1,0,0,0,0,0,0
DE Bernard ,West Indies,2009,2009,1,1,0,0,0,0,0,0
D Berthe ,Mali,2024,2024,2,2,0,0,0,0,0,0
TL Best ,West Indies,2013,2014,6,6,0,0,0,0,0,0
U Bhagwan ,Canada,2024,2024,4,4,0,0,0,0,0,0
IIR Bhana ,PAN,2023,2023,1,1,0,0,0,0,0,0
P Bharat Patel ,PAN,2019,2019,2,2,0,0,0,0,0,0
R Bhardwaj ,PORT,2021,2021,1,1,0,0,0,0,0,0
S Bhari ,NEP,2019,2021,9,9,0,0,0,0,0,0
A Bhattarai ,NEP,2014,2014,1,1,0,0,0,0,0,0
U Bhatti ,Canada,2008,2010,7,7,0,0,0,0,0,0
E Bhonkar ,ISR,2024,2024,3,3,0,0,0,0,0,0
S Biko ,Kenya,2022,2022,2,2,0,0,0,0,0,0
Bilal Aftab ,DEN,2021,2021,3,3,0,0,0,0,0,0
Bilal Ahmed ,SRB,2019,2019,1,1,0,0,0,0,0,0
IS Billcliff ,Canada,2010,2010,2,2,0,0,0,0,0,0
STR Binny ,India,2015,2016,3,3,0,0,0,0,0,0
KK Bishnoi ,BRA,2019,2019,3,3,0,0,0,0,0,0
CC Blake ,VAN,2019,2019,3,3,0,0,0,0,0,0
AM Blignaut ,Zimbabwe,2010,2010,1,1,0,0,0,0,0,0
GH Bodi ,South Africa,2007,2007,1,1,0,0,0,0,0,0
N Boje ,South Africa,2005,2005,1,1,0,0,0,0,0,0
VF Bomnyuy ,CAM,2024,2024,5,5,0,0,0,0,0,0
NE Bonner ,West Indies,2011,2012,2,2,0,0,0,0,0,0
CJ Boyce ,Australia,2014,2016,7,7,0,0,0,0,0,0
R Brar ,CYP,2021,2024,5,5,0,0,0,0,0,0
M Brasier ,FIN,2022,2023,3,3,0,0,0,0,0,0
M Breban ,GUE,2020,2020,1,1,0,0,0,0,0,0
T Britton ,JER,2024,2024,1,1,0,0,0,0,0,0
CA Brown ,Blz,2021,2021,4,4,0,0,0,0,0,0
DR Brown ,Scotland,2007,2007,2,1,0,0,0,0,0,0
T Brown ,Bhm,2023,2023,4,4,0,0,0,0,0,0
PL Bruno ,Arg,2021,2021,6,6,0,0,0,0,0,0
J Buchanan ,CAY,2023,2023,3,3,0,0,0,0,0,0
NB Budayair ,NEP,2014,2014,4,4,0,0,0,0,0,0
IW Budiarta ,INA,2022,2024,5,5,0,0,0,0,0,0
T Bukenya ,UGA,2020,2021,4,4,0,0,0,0,0,0
A Bulow ,DEN,2019,2019,2,1,0,0,0,0,0,0
S Burdekin ,CYP,2024,2024,10,10,0,0,0,0,0,0
T Buri ,THA,2022,2022,1,1,0,0,0,0,0,0
N Burger ,South Africa,2023,2024,2,2,0,0,0,0,0,0
CG Burnett ,Scotland,2013,2013,1,1,0,0,0,0,0,0
K Burrows ,Bhm,2022,2022,1,1,0,0,0,0,0,0
S Byrne ,MLT,2019,2019,2,2,0,0,0,0,0,0
P Byron ,SEY,2021,2021,1,1,0,0,0,0,0,0
G Caisley ,BRA,2019,2024,5,5,0,0,0,0,0,0
P Campbell ,GMB,2022,2022,5,5,0,0,0,0,0,0
F Campbell ,GMB,2022,2024,10,10,0,0,0,0,0,0
FE Carava ,MOZ,2021,2022,12,12,0,0,0,0,0,0
Y Cariah ,West Indies,2022,2022,2,2,0,0,0,0,0,0
A Carthew ,Chile,2019,2023,6,6,0,0,0,0,0,0
T Caruana ,GIBR,2019,2019,2,2,0,0,0,0,0,0
D Cato ,CAY,2019,2019,3,3,0,0,0,0,0,0
JJ Celestine ,BER,2008,2008,3,3,0,0,0,0,0,0
Charanjeet Singh ,ITA,2019,2019,3,2,0,0,0,0,0,0
A Chaudhary ,SGP,2023,2024,5,5,0,0,0,0,0,0
M Chauhan ,FIN,2019,2019,2,2,0,0,0,0,0,0
JF Chester ,SWA,2021,2021,4,4,0,0,0,0,0,0
Chirag Suri ,United Arab Emirates,2018,2022,31,31,0,0,0,0,0,0
T Chopel ,BHU,2024,2024,1,1,0,0,0,0,0,0
F Choudary ,SWE,2022,2022,2,2,0,0,0,0,0,0
DO Christian ,West Indies,2011,2011,2,2,0,0,0,0,0,0
AT Chuvale ,MOZ,2022,2022,1,1,0,0,0,0,0,0
Cihan Altun ,TKY,2023,2023,3,2,0,0,0,0,0,0
I Civric ,SRB,2019,2019,1,1,0,0,0,0,0,0
S Clarke ,IOM,2024,2024,1,1,0,0,0,0,0,0
DKJ Claude ,CIV,2024,2024,1,1,0,0,0,0,0,0
SL Clephane ,CZK-R,2022,2022,2,2,0,0,0,0,0,0
GL Cloete ,South Africa,2018,2019,2,2,0,0,0,0,0,0
FRJ Coleman ,Scotland,2013,2013,1,1,0,0,0,0,0,0
BRF Constanzo ,Chile,2023,2023,1,1,0,0,0,0,0,0
MNR Cooray ,MDV,2019,2020,7,7,0,0,0,0,0,0
BKB Corbin ,CAY,2023,2023,7,7,0,0,0,0,0,0
J Clough ,IOM,2022,2022,1,1,0,0,0,0,0,0
MS Crane ,England,2017,2017,2,2,0,0,0,0,0,0
L Croospulle ,Sri Lanka,2023,2023,1,1,0,0,0,0,0,0
T Cross ,EST,2021,2021,2,2,0,0,0,0,0,0
E Cruz ,CRC,2024,2024,1,1,0,0,0,0,0,0
R Cunningham ,GIBR,2021,2022,7,7,0,0,0,0,0,0
TL Cutler ,VAN,2024,2024,11,11,0,0,0,0,0,0
D Daesrath ,Canada,2013,2013,1,1,0,0,0,0,0,0
H Dajc ,SRB,2019,2019,2,2,0,0,0,0,0,0
P Dakainivanua ,Fiji,2023,2024,10,10,0,0,0,0,0,0
S Daniel ,Sri Lanka,2023,2023,1,1,0,0,0,0,0,0
Danish Aziz ,Pakistan,2021,2021,2,2,0,0,0,0,0,0
JT Darrell ,BER,2021,2023,2,2,0,0,0,0,0,0
Darwish Rasooli ,Afghanistan,2022,2024,7,7,0,0,0,0,0,0
H Davids ,South Africa,2012,2013,9,9,0,0,0,0,0,0
JJ Davidson ,Scotland,2024,2024,1,1,0,0,0,0,0,0
David Demba ,GMB,2023,2023,2,2,0,0,0,0,0,0
R Davson ,Bhm,2021,2022,6,6,0,0,0,0,0,0
D Dawa ,BHU,2024,2024,3,3,0,0,0,0,0,0
Dawlat Ahmadzai ,Afghanistan,2010,2010,2,2,0,0,0,0,0,0
A Daxini ,CRT,2023,2023,4,3,0,0,0,0,0,0
S Delai ,Fiji,2022,2022,1,1,0,0,0,0,0,0
DC Delany ,Ireland,2019,2019,8,8,0,0,0,0,0,0
D de la Puente ,Peru,2019,2019,2,2,0,0,0,0,0,0
Deng Jinqi ,CHN,2023,2024,6,6,0,0,0,0,0,0
A Denuwan ,ITA,2022,2022,3,3,0,0,0,0,0,0
PA Desai ,Canada,2012,2012,1,1,0,0,0,0,0,0
ST de Silva ,Sri Lanka,2017,2017,3,3,0,0,0,0,0,0
JI de Villiers ,Namibia,2024,2024,2,2,0,0,0,0,0,0
DV Devjani Mutreja ,Mex,2024,2024,3,3,0,0,0,0,0,0
S Dhakal ,NEP,2022,2024,6,6,0,0,0,0,0,0
N Dhamba ,OMA,2022,2022,1,1,0,0,0,0,0,0
R Dhiman ,BUL,2022,2022,4,4,0,0,0,0,0,0
SG Diaby ,Mali,2022,2023,9,8,0,0,0,0,0,0
MS Diakite ,Mali,2022,2024,11,11,0,0,0,0,0,0
BJ Diamanti ,New Zealand,2009,2009,1,1,0,0,0,0,0,0
MS Diawara ,Mali,2022,2023,10,9,0,0,0,0,0,0
V Dikov ,BUL,2019,2019,3,3,0,0,0,0,0,0
LHD Dilhara ,Sri Lanka,2008,2008,2,2,0,0,0,0,0,0
PK Dimitri ,CIV,2024,2024,1,1,0,0,0,0,0,0
N Dipakkumar Patel ,PAN,2019,2019,3,3,0,0,0,0,0,0
HH Dippenaar ,South Africa,2006,2006,1,1,0,0,0,0,0,0
Y Divekar ,ISR,2024,2024,3,3,0,0,0,0,0,0
Divyes Kumar ,MLT,2022,2022,1,1,0,0,0,0,0,0
QF Djakaridja ,CIV,2024,2024,1,1,0,0,0,0,0,0
BM Dlamini ,SWZ,2022,2022,5,5,0,0,0,0,0,0
LE Dlamini ,SWZ,2022,2024,9,8,0,0,0,0,0,0
TW Dlamini ,SWZ,2024,2024,2,2,0,0,0,0,0,0
W Dlamini ,SWZ,2022,2022,8,8,0,0,0,0,0,0
KK Dobell ,Japan,2022,2022,3,3,0,0,0,0,0,0
XJ Doherty ,Australia,2012,2013,11,11,0,0,0,0,0,0
A Donovan ,PHI,2024,2024,3,3,0,0,0,0,0,0
MR Dorgan ,SRB,2021,2021,3,3,0,0,0,0,0,0
K Dorji ,BHU,2019,2019,2,2,0,0,0,0,0,0
U Dorji ,BHU,2019,2019,2,2,0,0,0,0,0,0
TM Dowlin ,West Indies,2009,2010,2,2,0,0,0,0,0,0
A Dowling ,BUL,2024,2024,1,1,0,0,0,0,0,0
R Dravid ,India,2011,2011,1,1,0,0,0,0,0,0
O Duff ,BUL,2024,2024,2,2,0,0,0,0,0,0
S Duggan ,Arg,2023,2023,2,2,0,0,0,0,0,0
ROC Dunka ,CAY,2023,2023,3,3,0,0,0,0,0,0
J Dunn ,VAN,2019,2019,4,4,0,0,0,0,0,0
MD du Preez ,Namibia,2021,2021,3,3,0,0,0,0,0,0
PS Eaglestone ,Ireland,2010,2010,1,1,0,0,0,0,0,0
Ebadot Hossain ,BAN,2022,2022,4,4,0,0,0,0,0,0
KR Ebanks ,CAY,2019,2019,5,5,0,0,0,0,0,0
NH Ekanayake ,Bhm,2023,2023,4,4,0,0,0,0,0,0
S Elayaperumal ,Mex,2024,2024,5,5,0,0,0,0,0,0
Elias Hasan ,EST,2022,2022,6,6,0,0,0,0,0,0
JKP Ellick ,STHEL,2022,2022,2,2,0,0,0,0,0,0
AM Ellis ,New Zealand,2012,2013,5,5,0,0,0,0,0,0
C Emmott ,Chile,2019,2019,2,2,0,0,0,0,0,0
RR Emrit ,West Indies,2018,2018,4,4,0,0,0,0,0,0
J Essex ,STHEL,2024,2024,1,1,0,0,0,0,0,0
LKW Ezechiel ,CIV,2024,2024,1,1,0,0,0,0,0,0
Fahad Nawaz ,United Arab Emirates,2022,2022,1,1,0,0,0,0,0,0
Faizalmahmed Patel ,SWZ,2023,2023,2,2,0,0,0,0,0,0
Faizan Asif ,United Arab Emirates,2014,2015,6,6,0,0,0,0,0,0
Faizan Mumtaz ,NOR,2021,2021,3,3,0,0,0,0,0,0
A Faletar ,CRT,2023,2023,4,3,0,0,0,0,0,0
D Faletar ,CRT,2023,2023,4,3,0,0,0,0,0,0
IM Farrell ,GIBR,2022,2022,1,1,0,0,0,0,0,0
Fawad Ahmed ,Australia,2013,2013,2,2,0,0,0,0,0,0
Fayaz Mohammad ,BUL,2020,2022,5,4,0,0,0,0,0,0
Fazal Niazai ,Afghanistan,2019,2019,1,1,0,0,0,0,0,0
BOP Fernando ,Sri Lanka,2019,2021,7,6,0,0,0,0,0,0
MGSM Fernando ,ITA,2021,2021,6,6,0,0,0,0,0,0
MVT Fernando ,Sri Lanka,2017,2017,1,1,0,0,0,0,0,0
P Fernando ,ITA,2022,2022,2,2,0,0,0,0,0,0
Fiaz Ahmad ,KUW,2019,2019,3,3,0,0,0,0,0,0
Fida Hussain ,ITA,2019,2019,2,2,0,0,0,0,0,0
T Filer ,EST,2021,2021,5,5,0,0,0,0,0,0
R Flannigan ,Scotland,2012,2012,4,4,0,0,0,0,0,0
KK Flowers ,Blz,2019,2019,3,3,0,0,0,0,0,0
C Floyd ,NED,2019,2022,4,4,0,0,0,0,0,0
AD Fofana ,Mali,2024,2024,3,3,0,0,0,0,0,0
S Fouche ,Namibia,2024,2024,3,2,0,0,0,0,0,0
ZGF Foulkes ,New Zealand,2024,2024,4,4,0,0,0,0,0,0
R Fox ,Bhm,2022,2022,4,4,0,0,0,0,0,0
R Francis ,STHEL,2022,2024,8,7,0,0,0,0,0,0
E Frimpong ,GHA,2024,2024,4,4,0,0,0,0,0,0
Gabor Torok ,HUN,2022,2022,1,1,0,0,0,0,0,0
Gagandeep Singh ,GHA,2022,2022,2,2,0,0,0,0,0,0
AR Gandhi ,Kenya,2019,2019,3,3,0,0,0,0,0,0
D Ganga ,West Indies,2006,2006,1,1,0,0,0,0,0,0
S Gantulga ,MNG,2024,2024,6,6,0,0,0,0,0,0
GHS Garton ,England,2022,2022,1,1,0,0,0,0,0,0
A Gasteratos ,GRC,2022,2024,6,6,0,0,0,0,0,0
SP Gauchan ,NEP,2014,2015,9,9,0,0,0,0,0,0
A Gavde ,CAY,2019,2019,1,1,0,0,0,0,0,0
B Geeves ,Australia,2009,2009,1,1,0,0,0,0,0,0
J Ghadiyali ,SWA,2021,2021,6,6,0,0,0,0,0,0
L Gherasim ,ROM,2019,2023,8,8,0,0,0,0,0,0
JN Gillespie ,Australia,2005,2005,1,1,0,0,0,0,0,0
NT Gireesh ,CAM,2024,2024,3,3,0,0,0,0,0,0
J Giyanani ,United Arab Emirates,2023,2023,1,1,0,0,0,0,0,0
O Goker ,TKY,2019,2019,1,1,0,0,0,0,0,0
P Gopalkrishnan ,QAT,2024,2024,1,1,0,0,0,0,0,0
D Gough ,England,2005,2006,2,2,0,0,0,0,0,0
S Goustis ,GRC,2019,2019,3,3,0,0,0,0,0,0
K Govind ,SEY,2021,2021,1,1,0,0,0,0,0,0
L Gregory ,England,2019,2021,9,8,0,0,0,0,0,0
J Gumbie ,Zimbabwe,2024,2024,3,3,0,0,0,0,0,0
KDACK Gunarathne ,CAM,2024,2024,3,3,0,0,0,0,0,0
R Gunasekera ,Canada,2012,2013,8,8,0,0,0,0,0,0
HF Gurney ,England,2014,2014,2,2,0,0,0,0,0,0
GE Gutierrez Chavez ,Mex,2024,2024,3,3,0,0,0,0,0,0
H Hajnic ,CRT,2023,2023,4,3,0,0,0,0,0,0
SU Halarnkar ,CRC,2024,2024,2,2,0,0,0,0,0,0
AJ Hall ,South Africa,2006,2006,2,2,0,0,0,0,0,0
Hamid Hashemi ,Iran,2020,2020,1,1,0,0,0,0,0,0
PSP Handscomb ,Australia,2019,2019,2,2,0,0,0,0,0,0
Hardev Singh ,Chile,2019,2019,3,3,0,0,0,0,0,0
A Harikumar ,BUL,2021,2021,1,1,0,0,0,0,0,0
HL Harji ,SEY,2021,2024,8,8,0,0,0,0,0,0
Haroon Shahid ,KUW,2022,2022,2,2,0,0,0,0,0,0
Harprit Singh ,Mex,2023,2024,2,2,0,0,0,0,0,0
RJ Harris ,Australia,2010,2010,3,3,0,0,0,0,0,0
RW Hartley ,SRB,2024,2024,2,2,0,0,0,0,0,0
SM Harwood ,Australia,2007,2009,3,3,0,0,0,0,0,0
Hasan Cakir ,TKY,2022,2022,2,2,0,0,0,0,0,0
Hasan Murad ,BAN,2023,2023,2,2,0,0,0,0,0,0
Hasheem Shahzad ,MLT,2019,2019,2,2,0,0,0,0,0,0
Hashir Hussain ,NOR,2021,2021,1,1,0,0,0,0,0,0
Hassan Khan Mohammad ,Hong Kong,2020,2023,2,2,0,0,0,0,0,0
AA Hawoe ,INA,2024,2024,2,2,0,0,0,0,0,0
Hayatullah Niazi ,NOR,2019,2019,4,4,0,0,0,0,0,0
Hazrat Luqman ,United Arab Emirates,2024,2024,2,2,0,0,0,0,0,0
H Helva ,TKY,2019,2019,4,4,0,0,0,0,0,0
DL Hemp ,BER,2008,2008,2,2,0,0,0,0,0,0
T Henderson ,South Africa,2006,2006,1,1,0,0,0,0,0,0
JS Henriksen ,DEN,2023,2024,5,5,0,0,0,0,0,0
HMRKB Herath ,Sri Lanka,2011,2016,17,17,0,0,0,0,0,0
BW Hilfenhaus ,Australia,2007,2012,7,7,0,0,0,0,0,0
J Hill ,PHI,2019,2023,9,9,0,0,0,0,0,0
T Hinds ,West Indies,2024,2024,2,2,0,0,0,0,0,0
J Hirschi ,MLT,2019,2019,4,4,0,0,0,0,0,0
PA Hitchcock ,New Zealand,2008,2008,1,1,0,0,0,0,0,0
S Hongsi ,THA,2019,2023,5,5,0,0,0,0,0,0
PJ Hughes ,Australia,2014,2014,1,1,0,0,0,0,0,0
SJ Hughes-Pinan ,ESP,2024,2024,4,4,0,0,0,0,0,0
Humayun Kabir ,SWE,2021,2021,3,3,0,0,0,0,0,0
GI Hume ,Ireland,2022,2024,7,7,0,0,0,0,0,0
EH Hutchinson ,United States of America,2019,2021,4,4,0,0,0,0,0,0
RF Hutton ,PHI,2023,2023,1,1,0,0,0,0,0,0
Huzaif Yousuf ,BUL,2023,2024,6,5,0,0,0,0,0,0
M Ibrahim ,CIV,2024,2024,1,1,0,0,0,0,0,0
Ibrahim Kursad Dalyan ,TKY,2024,2024,3,3,0,0,0,0,0,0
Ibrahim Khan ,KSA,2019,2019,1,1,0,0,0,0,0,0
Ibrahim Sesay ,Sri LankaE,2023,2023,6,6,0,0,0,0,0,0
Iftikhar Anjum ,Pakistan,2007,2009,2,2,0,0,0,0,0,0
LU Igalagamage ,Sri Lanka,2023,2023,1,1,0,0,0,0,0,0
Ihsanullah ,Afghanistan,2022,2022,1,1,0,0,0,0,0,0
Ihsanullah ,Pakistan,2023,2023,4,4,0,0,0,0,0,0
Ijaz Ahmad Ahmadzai ,Afghanistan,2024,2024,3,3,0,0,0,0,0,0
AL Leutogi ,Samoa,2023,2023,2,2,0,0,0,0,0,0
Imam-ul-Haq ,Pakistan,2019,2019,2,2,0,0,0,0,0,0
Imran Bulbulia ,PAN,2019,2019,3,3,0,0,0,0,0,0
RK Inampud ,Mex,2019,2019,3,3,0,0,0,0,0,0
JD Inglis ,Chile,2023,2023,1,1,0,0,0,0,0,0
Inzamam-ul-Haq ,Pakistan,2006,2006,1,1,0,0,0,0,0,0
AJ Ireland ,Zimbabwe,2006,2006,1,1,0,0,0,0,0,0
Irfan Bhima ,MWest Indies,2019,2019,4,4,0,0,0,0,0,0
Irfan Mir ,Chile,2019,2019,4,4,0,0,0,0,0,0
G Irvin ,Bhm,2021,2021,2,2,0,0,0,0,0,0
E Isaneez ,UGA,2019,2019,3,3,0,0,0,0,0,0
Ismail Sardar ,THA,2020,2020,2,2,0,0,0,0,0,0
D Issiaka ,CIV,2024,2024,1,1,0,0,0,0,0,0
M Iturbe ,Arg,2023,2024,2,2,0,0,0,0,0,0
J Jagroo ,Bhm,2021,2022,11,11,0,0,0,0,0,0
Jahandad Khan ,Pakistan,2024,2024,1,1,0,0,0,0,0,0
Jaikumar Thakur ,CRT,2024,2024,2,2,0,0,0,0,0,0
NA Janes ,THA,2019,2019,2,2,0,0,0,0,0,0
D Jamyansuren ,MNG,2023,2024,5,5,0,0,0,0,0,0
H Jangariya ,SWZ,2023,2023,3,3,0,0,0,0,0,0
Abduljabar Jabarkhail ,Belg,2024,2024,6,6,0,0,0,0,0,0
AA Jasani ,TAN,2021,2021,6,6,0,0,0,0,0,0
Jason Lui ,Hong Kong,2024,2024,1,1,0,0,0,0,0,0
Javed Ahmadi ,Afghanistan,2012,2017,3,3,0,0,0,0,0,0
V Jayant ,LES,2022,2024,10,10,0,0,0,0,0,0
CU Jayasinghe ,Sri Lanka,2009,2010,5,5,0,0,0,0,0,0
P Jayawickrama ,Sri Lanka,2021,2022,5,5,0,0,0,0,0,0
B Jaye ,GMB,2024,2024,1,1,0,0,0,0,0,0
P Jayeshbhai Patel ,PAN,2019,2019,2,2,0,0,0,0,0,0
Jay Odedra ,OMA,2019,2024,5,5,0,0,0,0,0,0
S Jele ,SWZ,2024,2024,1,1,0,0,0,0,0,0
JS Jesani ,Kenya,2007,2007,1,1,0,0,0,0,0,0
Jitesh Patel ,MLT,2022,2022,4,4,0,0,0,0,0,0
Jobayer Hossen ,SEY,2024,2024,4,4,0,0,0,0,0,0
BE Johnson ,GUE,2022,2022,1,1,0,0,0,0,0,0
SH Johnson ,Australia,2023,2024,8,8,0,0,0,0,0,0
Jojo Thomas ,MLT,2021,2021,1,1,0,0,0,0,0,0
GJ Joseph ,Blz,2019,2019,1,1,0,0,0,0,0,0
K Joshi ,Aut,2019,2021,8,8,0,0,0,0,0,0
Jubair Hossain ,BAN,2015,2015,1,1,0,0,0,0,0,0
M Jukic ,CRT,2022,2022,2,2,0,0,0,0,0,0
Junaed Mullah ,SVN,2024,2024,2,2,0,0,0,0,0,0
Junaid Khan ,Pakistan,2011,2014,9,9,0,0,0,0,0,0
JMV Junior ,Fiji,2024,2024,2,2,0,0,0,0,0,0
S Jyoti ,Canada,2008,2008,2,2,0,0,0,0,0,0
M Kadyan ,BUL,2021,2022,12,12,0,0,0,0,0,0
E Kahamker ,ISR,2022,2022,4,4,0,0,0,0,0,0
B Kalki Kumar ,MLT,2021,2021,2,2,0,0,0,0,0,0
G Kaltongga ,VAN,2019,2019,3,3,0,0,0,0,0,0
S Randiv ,Sri Lanka,2010,2011,7,7,0,0,0,0,0,0
Kalyan Manne ,Mex,2024,2024,1,1,0,0,0,0,0,0
Kamran Wahid ,HUN,2024,2024,3,3,0,0,0,0,0,0
TP Kamungozi ,Zimbabwe,2014,2014,1,1,0,0,0,0,0,0
S Kansoy ,TKY,2019,2019,4,4,0,0,0,0,0,0
Kapil Kumar ,PHI,2022,2023,6,6,0,0,0,0,0,0
E Karimi ,DEN,2023,2024,8,8,0,0,0,0,0,0
B Karki ,NEP,2020,2020,1,1,0,0,0,0,0,0
A Karn ,NEP,2015,2015,2,2,0,0,0,0,0,0
NA Karnik ,SGP,2022,2022,4,4,0,0,0,0,0,0
SVA Karthikeyan ,ROM,2022,2022,2,2,0,0,0,0,0,0
Karthik Pillai ,BUL,2022,2022,2,2,0,0,0,0,0,0
M Kartik ,India,2007,2007,1,1,0,0,0,0,0,0
A Karvelas ,GRC,2022,2022,1,1,0,0,0,0,0,0
Kashif Abbas ,KSA,2023,2024,6,6,0,0,0,0,0,0
E Katchay ,Canada,2008,2008,4,4,0,0,0,0,0,0
S Kaul ,India,2018,2019,3,3,0,0,0,0,0,0
Kau Qalo ,Fiji,2024,2024,2,2,0,0,0,0,0,0
MJM Kavana ,COK,2024,2024,4,4,0,0,0,0,0,0
HB Kayondo ,UGA,2019,2021,4,4,0,0,0,0,0,0
D Kegasitswe ,BOT,2019,2019,4,4,0,0,0,0,0,0
SKW Kelly ,BER,2008,2008,3,3,0,0,0,0,0,0
P Kerai ,Kenya,2019,2019,6,6,0,0,0,0,0,0
Khalander Mustafa ,KSA,2023,2023,6,6,0,0,0,0,0,0
A Khan (DEN/ENG),NA,2009,2022,9,9,0,0,0,0,0,0
Khawar Zafar ,KSA,2020,2020,2,2,0,0,0,0,0,0
M Khojbariya ,SWZ,2024,2024,1,1,0,0,0,0,0,0
Khurram Manzoor ,Pakistan,2016,2016,3,3,0,0,0,0,0,0
GE Kidd ,Ireland,2010,2010,1,1,0,0,0,0,0,0
T Kirk ,GUE,2023,2023,1,1,0,0,0,0,0,0
RJ Kirtley ,England,2007,2007,1,1,0,0,0,0,0,0
S Kizilkaya ,TKY,2019,2019,4,4,0,0,0,0,0,0
MF Koc ,TKY,2019,2019,3,3,0,0,0,0,0,0
S Kollery ,BOT,2022,2022,2,2,0,0,0,0,0,0
Y Konate ,Mali,2024,2024,5,5,0,0,0,0,0,0
S Koppolu ,SVN,2022,2024,7,7,0,0,0,0,0,0
AC Kose ,TKY,2019,2019,4,4,0,0,0,0,0,0
GJP Kruger ,South Africa,2006,2006,1,1,0,0,0,0,0,0
S Kubheka (SWA/SWZ),NA,2021,2022,8,8,0,0,0,0,0,0
Kuldeep Gurjar ,SKOR,2022,2022,2,2,0,0,0,0,0,0
DS Kulkarni ,India,2016,2016,2,2,0,0,0,0,0,0
Kulwinderjeet Singh ,PHI,2023,2024,8,8,0,0,0,0,0,0
E Kuyumcu ,TKY,2022,2022,3,3,0,0,0,0,0,0
TK Lal ,CZK-R,2022,2022,8,8,0,0,0,0,0,0
GA Lamb ,Zimbabwe,2010,2010,5,5,0,0,0,0,0,0
W Landman ,SWZ,2023,2023,3,3,0,0,0,0,0,0
T Langa ,VAN,2019,2019,1,1,0,0,0,0,0,0
A Langham ,STHEL,2022,2022,7,6,0,0,0,0,0,0
J Lassayo ,Sri LankaE,2023,2023,1,1,0,0,0,0,0,0
YC Latouche ,CRC,2024,2024,1,1,0,0,0,0,0,0
E Leie ,South Africa,2015,2015,2,2,0,0,0,0,0,0
SE Leluma ,LES,2024,2024,1,1,0,0,0,0,0,0
B Leo ,STHEL,2024,2024,1,1,0,0,0,0,0,0
M Leporoporo ,LES,2021,2024,7,7,0,0,0,0,0,0
T Letsitsa ,LES,2021,2021,1,1,0,0,0,0,0,0
RDM Leverock ,BER,2008,2008,2,2,0,0,0,0,0,0
C Liebenberg ,IOM,2020,2020,1,1,0,0,0,0,0,0
J Linton ,CAY,2022,2022,3,3,0,0,0,0,0,0
I Lisboa ,Chile,2019,2023,2,2,0,0,0,0,0,0
CA Liyanage ,MDV,2019,2023,4,4,0,0,0,0,0,0
NG Liyanage ,HUN,2021,2021,2,2,0,0,0,0,0,0
K Loday ,BHU,2019,2019,1,1,0,0,0,0,0,0
J Louw ,South Africa,2008,2009,2,2,0,0,0,0,0,0
L Louwrens ,Namibia,2019,2019,1,1,0,0,0,0,0,0
WJ Lubbe ,South Africa,2021,2021,2,2,0,0,0,0,0,0
Luo Shilin ,CHN,2023,2024,11,11,0,0,0,0,0,0
Lwin Maw ,MYAN,2024,2024,2,2,0,0,0,0,0,0
NM Lyon ,Australia,2016,2018,2,2,0,0,0,0,0,0
RT Lyons ,Scotland,2010,2010,2,2,0,0,0,0,0,0
Maaz Patel ,SWZ,2024,2024,1,1,0,0,0,0,0,0
AM McCarthy ,West Indies,2018,2018,1,1,0,0,0,0,0,0
NFI McCallum ,Scotland,2007,2010,11,10,0,0,0,0,0,0
AJ McKay ,New Zealand,2010,2010,2,2,0,0,0,0,0,0
CJ McKay ,Australia,2010,2013,6,6,0,0,0,0,0,0
ND McKenzie ,South Africa,2006,2009,2,2,0,0,0,0,0,0
S Maduranga ,SKOR,2024,2024,6,6,0,0,0,0,0,0
DSK Madushanka ,Sri Lanka,2018,2018,2,2,0,0,0,0,0,0
LD Madushanka ,Sri Lanka,2019,2021,3,3,0,0,0,0,0,0
P Magafas ,GRC,2022,2022,4,4,0,0,0,0,0,0
RP Magar ,NEP,2014,2015,6,6,0,0,0,0,0,0
A Magdalenic ,CRT,2023,2024,9,8,0,0,0,0,0,0
R Mahajan ,PHI,2019,2019,3,3,0,0,0,0,0,0
B Mahesh ,CYP,2024,2024,6,6,0,0,0,0,0,0
C Mahoney ,Peru,2019,2019,3,3,0,0,0,0,0,0
Z Makadji ,Mali,2022,2024,8,8,0,0,0,0,0,0
C Malaya ,MWest Indies,2024,2024,5,5,0,0,0,0,0,0
D Malinga ,SWZ,2022,2022,3,3,0,0,0,0,0,0
D Matla ,SVN,2024,2024,1,1,0,0,0,0,0,0
A Manatos ,GRC,2021,2021,1,1,0,0,0,0,0,0
G Mangau ,VAN,2023,2023,3,3,0,0,0,0,0,0
SG Mangela ,UGA,2024,2024,2,2,0,0,0,0,0,0
M Manivannan ,CAY,2023,2023,1,1,0,0,0,0,0,0
L Maphane ,BOT,2022,2023,4,4,0,0,0,0,0,0
Maqsood Ahmad ,Belg,2021,2022,6,6,0,0,0,0,0,0
M Markande ,India,2019,2019,1,1,0,0,0,0,0,0
JAH Marshall ,New Zealand,2005,2008,3,3,0,0,0,0,0,0
JL Martel ,GUE,2019,2019,3,3,0,0,0,0,0,0
JK Masara ,Zimbabwe,2022,2022,1,1,0,0,0,0,0,0
P Masih ,ROM,2020,2020,3,3,0,0,0,0,0,0
MJ Mason ,New Zealand,2006,2008,3,3,0,0,0,0,0,0
Masood Jayezeh ,Iran,2020,2020,3,3,0,0,0,0,0,0
J Masquater ,TAN,2024,2024,6,6,0,0,0,0,0,0
N Master ,BOT,2019,2019,2,2,0,0,0,0,0,0
J Matharu ,Canada,2021,2022,7,7,0,0,0,0,0,0
ID Matic ,CRT,2023,2023,2,2,0,0,0,0,0,0
LF Mavume ,MOZ,2022,2023,7,7,0,0,0,0,0,0
W Maximo ,BRA,2024,2024,1,1,0,0,0,0,0,0
NP Mayavo ,Zimbabwe,2023,2023,1,1,0,0,0,0,0,0
Mazhar Khan ,SVN,2022,2024,5,5,0,0,0,0,0,0
Ma Qiancheng ,CHN,2023,2024,11,11,0,0,0,0,0,0
GJ McCarter ,Ireland,2015,2015,3,2,0,0,0,0,0,0
W McClintock ,Ireland,2021,2021,5,5,0,0,0,0,0,0
Z McLaughlin ,CAY,2019,2019,3,3,0,0,0,0,0,0
MD Shoyaib ,EST,2022,2022,2,2,0,0,0,0,0,0
Mehrab Hossain jnr ,BAN,2008,2009,2,2,0,0,0,0,0,0
Mehran Dorri ,Iran,2020,2020,1,1,0,0,0,0,0,0
Mehran Siasar ,Iran,2020,2020,1,1,0,0,0,0,0,0
B Mejaro ,LES,2024,2024,3,3,0,0,0,0,0,0
D Mejia ,CRC,2019,2019,3,3,0,0,0,0,0,0
AR Menon ,SGP,2023,2023,1,1,0,0,0,0,0,0
JH Mensah ,GHA,2019,2019,2,2,0,0,0,0,0,0
RP Meredith ,Australia,2021,2024,6,6,0,0,0,0,0,0
J Meza ,CRC,2024,2024,1,1,0,0,0,0,0,0
Michael Nazir ,MLT,2019,2019,1,1,0,0,0,0,0,0
Mihusan Hamid ,MDV,2019,2019,1,1,0,0,0,0,0,0
S Mills ,IOM,2020,2020,1,1,0,0,0,0,0,0
K Mishara ,Sri Lanka,2022,2022,3,3,0,0,0,0,0,0
T Misi ,Samoa,2024,2024,2,2,0,0,0,0,0,0
Y Mitari ,RWN,2021,2022,19,18,0,0,0,0,0,0
B Mngoma ,SWZ,2024,2024,3,3,0,0,0,0,0,0
Mobashar Ashraf ,Fran,2021,2021,2,2,0,0,0,0,0,0
D Mogan ,MAS,2020,2021,3,3,0,0,0,0,0,0
OK Mohamed ,CIV,2024,2024,1,1,0,0,0,0,0,0
Mohamed Fadiga ,Mali,2024,2024,1,1,0,0,0,0,0,0
Mohammad Shamshad Khan ,Sri LankaE,2022,2022,6,6,0,0,0,0,0,0
Mohammad Adnan ,KSA,2019,2019,5,5,0,0,0,0,0,0
Mohammad Ahsan ,KUW,2019,2019,6,6,0,0,0,0,0,0
Mohammad Ayaz ,United Arab Emirates,2020,2020,1,1,0,0,0,0,0,0
Mohammad Iqbal ,Canada,2008,2008,3,3,0,0,0,0,0,0
Mohamed Mahfooz ,MDV,2019,2021,15,15,0,0,0,0,0,0
Mohammad Qazi ,Canada,2008,2008,1,1,0,0,0,0,0,0
Mohammad Rafique ,BAN,2006,2006,1,1,0,0,0,0,0,0
Mohammad Saleem ,Afghanistan,2024,2024,1,1,0,0,0,0,0,0
Mohammad Shahid ,BAN,2016,2016,1,1,0,0,0,0,0,0
Mohammed Alamgir ,SWZ,2022,2024,10,9,0,0,0,0,0,0
Mohammed Aslam ,QAT,2024,2024,1,1,0,0,0,0,0,0
Mohammed Sameer ,BHR,2020,2020,2,2,0,0,0,0,0,0
S Mohan ,PHI,2022,2022,1,1,0,0,0,0,0,0
Mohsin Shabbir ,KSA,2023,2023,3,3,0,0,0,0,0,0
Mohsin Zaki ,BHR,2023,2023,5,5,0,0,0,0,0,0
R Mondol ,BAN,2023,2023,3,3,0,0,0,0,0,0
A Mongar ,BHU,2023,2023,2,2,0,0,0,0,0,0
MR Montfort ,Canada,2019,2019,1,1,0,0,0,0,0,0
M Montgomery ,GER,2023,2023,1,1,0,0,0,0,0,0
VV Morea ,Papau New Guinea,2015,2017,5,5,0,0,0,0,0,0
A Morris ,CAY,2019,2023,12,12,0,0,0,0,0,0
Mohsin Hub ,Peru,2019,2019,4,4,0,0,0,0,0,0
Mohsin Khan ,Hong Kong,2020,2020,3,3,0,0,0,0,0,0
N Mourikis ,GRC,2021,2021,3,3,0,0,0,0,0,0
Muaviath Ganee ,MDV,2019,2023,7,7,0,0,0,0,0,0
Mubasir Khan ,Pakistan,2023,2023,1,1,0,0,0,0,0,0
Mubeen Tariq ,PORT,2023,2023,1,1,0,0,0,0,0,0
A Mucyodusenge ,RWN,2022,2022,1,1,0,0,0,0,0,0
Muzahir Raza ,OMA,2024,2024,3,3,0,0,0,0,0,0
Muhammad Zafar Khan ,TAN,2024,2024,5,5,0,0,0,0,0,0
Muhammad Ansar ,KUW,2020,2020,4,4,0,0,0,0,0,0
Muhammad Farooq ,CYP,2022,2022,1,1,0,0,0,0,0,0
Muhammad Hamayun ,KSA,2019,2019,4,4,0,0,0,0,0,0
Muhammad Musa ,Pakistan,2019,2020,2,2,0,0,0,0,0,0
Muhammad Rafique ,BHR,2019,2019,2,2,0,0,0,0,0,0
Muhammad Salman ,BHR,2024,2024,1,1,0,0,0,0,0,0
Muhammed Shanil ,United Arab Emirates,2016,2016,1,1,0,0,0,0,0,0
Muhammad Tahir ,GRC,2024,2024,2,2,0,0,0,0,0,0
Muhammad Zaghlool ,Blz,2021,2021,2,2,0,0,0,0,0,0
Muhammed Turkmen ,TKY,2023,2024,6,5,0,0,0,0,0,0
Muhammet Kursat ,TKY,2023,2023,4,3,0,0,0,0,0,0
Muhammad Babar ,ESP,2024,2024,2,2,0,0,0,0,0,0
Mukesh Singh ,Mex,2023,2023,1,1,0,0,0,0,0,0
Mukhtiar Singh ,ESP,2019,2019,2,2,0,0,0,0,0,0
Muktar Ali ,BAN,2016,2016,1,1,0,0,0,0,0,0
FF Mulivai ,Samoa,2019,2019,4,4,0,0,0,0,0,0
CT Mumba ,Zimbabwe,2020,2023,9,9,0,0,0,0,0,0
IS Munir ,UGA,2022,2022,1,1,0,0,0,0,0,0
E Munkhbat ,MNG,2023,2023,2,2,0,0,0,0,0,0
T Mupariwa ,Zimbabwe,2007,2008,4,4,0,0,0,0,0,0
Mustapha Yusuf ,NGA,2021,2021,5,5,0,0,0,0,0,0
P Mustard ,England,2008,2008,2,2,0,0,0,0,0,0
F Mutizwa ,Zimbabwe,2011,2012,3,3,0,0,0,0,0,0
D Mutu ,TKY,2022,2022,1,1,0,0,0,0,0,0
Nader Zahadiafzal ,Iran,2020,2020,3,3,0,0,0,0,0,0
Nadif Chowdhury ,BAN,2006,2007,3,3,0,0,0,0,0,0
A Nagarajan ,QAT,2024,2024,1,1,0,0,0,0,0,0
K Nagnama ,CIV,2024,2024,1,1,0,0,0,0,0,0
Naiem Bameri ,Iran,2020,2020,3,3,0,0,0,0,0,0
Najeeb Amar ,Hong Kong,2014,2014,1,1,0,0,0,0,0,0
M Nandela ,Mex,2019,2019,2,2,0,0,0,0,0,0
BM Narasimha ,Mex,2023,2023,1,1,0,0,0,0,0,0
PV Naringrekar ,CRC,2024,2024,1,1,0,0,0,0,0,0
Naseer Naail Ismail ,MDV,2023,2023,2,2,0,0,0,0,0,0
Nasir Aziz ,United Arab Emirates,2015,2015,1,1,0,0,0,0,0,0
T Natarajan ,India,2020,2021,4,4,0,0,0,0,0,0
Nauman Anwar ,Pakistan,2015,2015,1,1,0,0,0,0,0,0
NH Naureen ,ESP,2019,2019,1,1,0,0,0,0,0,0
Navid Balouch ,Iran,2020,2020,3,3,0,0,0,0,0,0
Navid Abdollahpour ,Iran,2020,2020,2,2,0,0,0,0,0,0
Nazimuddin ,BAN,2007,2008,7,7,0,0,0,0,0,0
Nazmul Hossain ,BAN,2009,2012,4,4,0,0,0,0,0,0
Nazmus Sadat ,BAN,2006,2006,1,1,0,0,0,0,0,0
R Neale ,LUX,2019,2019,3,3,0,0,0,0,0,0
S Nerandzic ,SRB,2019,2022,3,3,0,0,0,0,0,0
JO Ngoche ,Kenya,2012,2013,7,7,0,0,0,0,0,0
W Ngowhuad ,THA,2024,2024,2,2,0,0,0,0,0,0
NZ Nhaduate ,MOZ,2023,2023,2,2,0,0,0,0,0,0
Niaz Ali ,Hong Kong,2023,2023,5,5,0,0,0,0,0,0
K Nima ,BHU,2019,2019,1,1,0,0,0,0,0,0
EM Nino ,Arg,2021,2021,2,2,0,0,0,0,0,0
N Nazmussakib ,SKOR,2022,2022,2,2,0,0,0,0,0,0
K Nitish Kumar Reddy ,India,2024,2024,3,3,0,0,0,0,0,0
ML Nkala ,Zimbabwe,2006,2006,1,1,0,0,0,0,0,0
F Nkhoma ,MWest Indies,2019,2024,6,6,0,0,0,0,0,0
W Nkosana ,BOT,2023,2023,1,1,0,0,0,0,0,0
AA Noffke ,Australia,2007,2008,2,2,0,0,0,0,0,0
Noman Kamawi ,Belg,2019,2019,1,1,0,0,0,0,0,0
Noorullah Sidiqi ,Belg,2023,2023,1,1,0,0,0,0,0,0
MJ North ,Australia,2009,2009,1,1,0,0,0,0,0,0
L Nou ,Papau New Guinea,2015,2015,3,3,0,0,0,0,0,0
Nouman Butt ,NOR,2023,2023,2,2,0,0,0,0,0,0
Nurudeen Ibrahim ,GHA,2023,2023,1,1,0,0,0,0,0,0
HS Nyakatawa ,SWZ,2022,2022,6,6,0,0,0,0,0,0
J Nyumbu ,Zimbabwe,2018,2018,2,2,0,0,0,0,0,0
W O'Rourke ,New Zealand,2024,2024,3,3,0,0,0,0,0,0
IE O'Brien ,New Zealand,2009,2009,4,4,0,0,0,0,0,0
AR Odedara ,OMA,2024,2024,3,3,0,0,0,0,0,0
S Ogundipe ,NGA,2021,2021,4,4,0,0,0,0,0,0
NV Ojha ,India,2010,2010,2,2,0,0,0,0,0,0
G Oliveira ,BRA,2024,2024,1,1,0,0,0,0,0,0
C Olphert ,Ireland,2022,2022,2,2,0,0,0,0,0,0
PJ Ongondo ,Kenya,2007,2008,8,8,0,0,0,0,0,0
LN Onyango ,Kenya,2007,2010,5,5,0,0,0,0,0,0
A Orfila ,GIBR,2019,2021,5,5,0,0,0,0,0,0
CG Osborne ,CRT,2023,2023,2,2,0,0,0,0,0,0
CL Outerbridge ,BER,2023,2023,4,4,0,0,0,0,0,0
Ovais Yousof ,NGA,2019,2019,3,3,0,0,0,0,0,0
Owais Ahmed ,QAT,2024,2024,1,1,0,0,0,0,0,0
D Padikkal ,India,2021,2021,2,2,0,0,0,0,0,0
DK Pallekonda ,SVN,2022,2024,4,4,0,0,0,0,0,0
MS Panesar ,England,2007,2007,1,1,0,0,0,0,0,0
J Pant ,LUX,2023,2023,1,1,0,0,0,0,0,0
AA Paradkar ,United States of America,2024,2024,4,4,0,0,0,0,0,0
BA Parchment ,West Indies,2007,2007,1,1,0,0,0,0,0,0
MA Parker ,Scotland,2012,2012,2,2,0,0,0,0,0,0
R Parkin ,EST,2024,2024,4,4,0,0,0,0,0,0
Parveen Kumar ,FIN,2022,2024,7,7,0,0,0,0,0,0
Parvez Rasool ,India,2017,2017,1,1,0,0,0,0,0,0
A Patel ,MWest Indies,2019,2019,2,2,0,0,0,0,0,0
AM Patel ,PAN,2023,2023,2,2,0,0,0,0,0,0
AP Patel ,Canada,2024,2024,1,1,0,0,0,0,0,0
AY Patel ,New Zealand,2018,2021,7,7,0,0,0,0,0,0
FL Patel ,PAN,2023,2023,6,6,0,0,0,0,0,0
KJ Patel ,SEY,2021,2021,6,6,0,0,0,0,0,0
M Patel ,PAN,2019,2019,2,2,0,0,0,0,0,0
M Patel ,Chile,2019,2019,3,3,0,0,0,0,0,0
MIA Patel ,MWest Indies,2019,2019,3,3,0,0,0,0,0,0
MM Patel ,India,2011,2011,3,3,0,0,0,0,0,0
SK Patel ,United States of America,2024,2024,2,2,0,0,0,0,0,0
TK Patel ,United States of America,2019,2019,7,7,0,0,0,0,0,0
N Pathan ,THA,2019,2020,8,8,0,0,0,0,0,0
R Pathan ,Canada,2021,2024,14,13,0,0,0,0,0,0
SS Pathirana ,Sri Lanka,2016,2017,5,5,0,0,0,0,0,0
TAW Patterson ,Blz,2021,2021,3,3,0,0,0,0,0,0
W Perchard ,JER,2024,2024,1,1,0,0,0,0,0,0
MDK Perera ,Sri Lanka,2011,2011,3,3,0,0,0,0,0,0
PDRL Perera ,Sri Lanka,2006,2006,2,2,0,0,0,0,0,0
V Permaul ,West Indies,2018,2018,1,1,0,0,0,0,0,0
N Peter ,South Africa,2024,2024,6,6,0,0,0,0,0,0
AM Phangiso ,South Africa,2012,2018,16,16,0,0,0,0,0,0
T Phaswana ,BOT,2019,2019,1,1,0,0,0,0,0,0
JR Philippe ,Australia,2021,2023,12,12,0,0,0,0,0,0
Phon Bunthean ,CAM,2023,2024,11,11,0,0,0,0,0,0
F Pieters ,SKOR,2024,2024,1,1,0,0,0,0,0,0
H Pile ,GIBR,2024,2024,2,2,0,0,0,0,0,0
B Pita ,Samoa,2023,2023,1,1,0,0,0,0,0,0
D Polpitiya ,SWZ,2022,2022,6,6,0,0,0,0,0,0
LA Pomersbach ,Australia,2007,2007,1,1,0,0,0,0,0,0
VRCF Poubel ,BRA,2019,2019,3,3,0,0,0,0,0,0
H Pragji ,BOT,2019,2019,4,4,0,0,0,0,0,0
C Prasad ,CRC,2019,2019,3,3,0,0,0,0,0,0
KTGD Prasad ,Sri Lanka,2011,2011,1,1,0,0,0,0,0,0
M Prasanna ,ROM,2023,2023,4,4,0,0,0,0,0,0
A Prashar ,HUN,2023,2023,5,5,0,0,0,0,0,0
M Prasidh Krishna ,India,2023,2023,5,5,0,0,0,0,0,0
AG Prince ,South Africa,2005,2005,1,1,0,0,0,0,0,0
SMA Priyanjan ,Sri Lanka,2017,2017,3,3,0,0,0,0,0,0
V Pulibanti ,CRT,2023,2024,7,7,0,0,0,0,0,0
Qalandar Khan ,QAT,2019,2019,4,4,0,0,0,0,0,0
Qasim Anwar ,CYP,2021,2021,4,4,0,0,0,0,0,0
Qasim Zia ,BHR,2019,2019,3,3,0,0,0,0,0,0
Rafaqat Ali ,NOR,2023,2023,1,1,0,0,0,0,0,0
Rafatullah Mohmand ,Pakistan,2015,2015,3,3,0,0,0,0,0,0
Raghav Dhawan ,UGA,2024,2024,2,2,0,0,0,0,0,0
Rahman Ademi ,SRB,2019,2024,9,8,0,0,0,0,0,0
Rahmat Shah ,Afghanistan,2024,2024,1,1,0,0,0,0,0,0
P Raho ,Papau New Guinea,2016,2016,2,2,0,0,0,0,0,0
EC Rainsford ,Zimbabwe,2010,2010,2,2,0,0,0,0,0,0
Rajab Hussain ,Hong Kong,2024,2024,2,2,0,0,0,0,0,0
TKP Rajapaksha ,SEY,2022,2024,12,11,0,0,0,0,0,0
T Rajiv ,SEY,2021,2021,6,6,0,0,0,0,0,0
Rajkumar Rajendran ,MAS,2024,2024,3,3,0,0,0,0,0,0
Rakibul Hasan ,ITA,2019,2019,8,7,0,0,0,0,0,0
RLB Rambukwella ,Sri Lanka,2013,2016,2,2,0,0,0,0,0,0
Rameez Khan ,ROM,2024,2024,5,5,0,0,0,0,0,0
Rameez Raja (2) ,Pakistan,2011,2011,2,2,0,0,0,0,0,0
TJ Ramphoma ,LES,2024,2024,4,4,0,0,0,0,0,0
Ram Krishan ,EST,2023,2023,1,1,0,0,0,0,0,0
N Rana ,India,2021,2021,2,2,0,0,0,0,0,0
SHA Rance ,New Zealand,2017,2019,8,7,0,0,0,0,0,0
DA Rankin ,Ireland,2015,2016,2,2,0,0,0,0,0,0
RJ Ranpura ,OMA,2015,2016,3,2,0,0,0,0,0,0
T Rapi ,Samoa,2023,2023,3,3,0,0,0,0,0,0
Rasheed Rassam ,MDV,2023,2024,3,3,0,0,0,0,0,0
Rashid Khan ,NEP,2019,2024,2,2,0,0,0,0,0,0
V Rathinasamy ,CRT,2024,2024,4,4,0,0,0,0,0,0
Raunaq Kapur ,Hong Kong,2024,2024,1,1,0,0,0,0,0,0
PF Ravarua ,COK,2024,2024,1,1,0,0,0,0,0,0
G Raymond ,COK,2022,2022,2,2,0,0,0,0,0,0
NJ Reardon ,Australia,2014,2014,2,2,0,0,0,0,0,0
J Reb ,SRB,2019,2023,8,8,0,0,0,0,0,0
RA Reifer ,West Indies,2022,2023,3,3,0,0,0,0,0,0
S Rengarajan ,CZK-R,2020,2020,3,3,0,0,0,0,0,0
C Rice ,MWest Indies,2021,2021,1,1,0,0,0,0,0,0
ACL Richards ,West Indies,2007,2007,1,1,0,0,0,0,0,0
DM Richards ,West Indies,2009,2009,1,1,0,0,0,0,0,0
G Richardson ,JER,2024,2024,1,1,0,0,0,0,0,0
G Riley ,GMB,2022,2024,3,3,0,0,0,0,0,0
R Rivas ,Chile,2019,2019,3,3,0,0,0,0,0,0
Riyaz Kajalwala ,CYP,2022,2022,2,2,0,0,0,0,0,0
Rizwan Mangera ,PAN,2021,2021,4,4,0,0,0,0,0,0
I Roberts ,Arg,2023,2023,1,1,0,0,0,0,0,0
WJR Robertson ,JER,2019,2019,6,6,0,0,0,0,0,0
D Robeson ,GIBR,2021,2021,1,1,0,0,0,0,0,0
TB Robinson ,New Zealand,2024,2024,6,5,0,0,0,0,0,0
Robiul Islam ,BAN,2013,2013,1,1,0,0,0,0,0,0
CM Rocca ,GIBR,2022,2022,2,2,0,0,0,0,0,0
SR Rocket ,SEY,2021,2024,15,14,0,0,0,0,0,0
AG Roe ,Chile,2023,2023,2,2,0,0,0,0,0,0
GA Rogers ,Scotland,2008,2009,2,2,0,0,0,0,0,0
Rohit Kumar ,ROM,2022,2023,5,5,0,0,0,0,0,0
BJ Rohrer ,Australia,2013,2013,1,1,0,0,0,0,0,0
Rokhan Barakzai ,Afghanistan,2015,2015,3,3,0,0,0,0,0,0
L Rossi ,Arg,2023,2024,3,3,0,0,0,0,0,0
O Rowe ,Arg,2023,2023,1,1,0,0,0,0,0,0
RT Rubbi ,INA,2024,2024,2,2,0,0,0,0,0,0
JA Rudolph ,South Africa,2006,2006,1,1,0,0,0,0,0,0
Sabir Ali ,United Arab Emirates,2022,2022,3,3,0,0,0,0,0,0
Mofassar Saeed ,NOR,2024,2024,1,1,0,0,0,0,0,0
TK Saha ,FIN,2019,2019,4,4,0,0,0,0,0,0
Shahbaz Ahmed ,India,2023,2023,2,2,0,0,0,0,0,0
BC Sahin ,TKY,2023,2023,3,2,0,0,0,0,0,0
Saif-Ul Islam ,NOR,2023,2023,2,2,0,0,0,0,0,0
B Sai Sudharsan ,India,2024,2024,1,1,0,0,0,0,0,0
Sajid Liaqat ,GER,2019,2024,9,9,0,0,0,0,0,0
Sajid Patel ,LES,2024,2024,4,4,0,0,0,0,0,0
C Sakariya ,India,2021,2021,2,2,0,0,0,0,0,0
Sakib Hasan ,SRB,2019,2019,2,2,0,0,0,0,0,0
SMLD Samarakoon ,Sri Lanka,2023,2023,1,1,0,0,0,0,0,0
D Samarawickrama ,ITA,2022,2022,3,3,0,0,0,0,0,0
E Samson ,ISR,2022,2022,3,3,0,0,0,0,0,0
RSK Samson ,VAN,2022,2022,2,2,0,0,0,0,0,0
TW Samuels ,Blz,2021,2021,5,5,0,0,0,0,0,0
O Sam Arthur ,CRC,2019,2019,3,3,0,0,0,0,0,0
R Sandeep ,SWZ,2024,2024,6,6,0,0,0,0,0,0
Sandeep Nair ,BUL,2022,2022,7,7,0,0,0,0,0,0
Sandeep Sharma ,India,2015,2015,2,2,0,0,0,0,0,0
S Sandeep Warrier ,India,2021,2021,1,1,0,0,0,0,0,0
BS Sandhu ,SVN,2022,2022,1,1,0,0,0,0,0,0
Sanjay Kumar ,HUN,2021,2021,2,2,0,0,0,0,0,0
OT Sankoh ,Sri LankaE,2021,2021,1,1,0,0,0,0,0,0
Sapan Mehta ,FIN,2022,2022,5,5,0,0,0,0,0,0
Saqlain Sajib ,BAN,2016,2016,1,1,0,0,0,0,0,0
Saran Aslam ,DEN,2022,2024,12,12,0,0,0,0,0,0
A Sathyan ,CRT,2024,2024,2,2,0,0,0,0,0,0
RR Saun ,CRC,2024,2024,3,3,0,0,0,0,0,0
RHO Saunders ,NOR,2022,2022,2,2,0,0,0,0,0,0
Saqib Naveed ,EST,2021,2022,4,4,0,0,0,0,0,0
IP Swaney ,SGP,2022,2024,5,5,0,0,0,0,0,0
A Sawyer ,GIBR,2023,2024,3,3,0,0,0,0,0,0
JE Scott ,Bhm,2023,2023,4,4,0,0,0,0,0,0
RM Scott ,United States of America,2021,2021,2,2,0,0,0,0,0,0
M Sedgwick ,EST,2021,2021,3,3,0,0,0,0,0,0
S Seelan ,INA,2023,2023,1,1,0,0,0,0,0,0
Seif Athumani ,TAN,2024,2024,1,1,0,0,0,0,0,0
YSD Seneveratne ,CAY,2019,2023,10,10,0,0,0,0,0,0
Serdar Burak Emir ,TKY,2024,2024,1,1,0,0,0,0,0,0
M Sert ,TKY,2019,2019,4,4,0,0,0,0,0,0
Shabbir Ahmed ,Pakistan,2007,2007,1,1,0,0,0,0,0,0
Shabir Noori ,Afghanistan,2012,2012,1,1,0,0,0,0,0,0
Shafat Ali Syed ,ESP,2023,2024,10,9,0,0,0,0,0,0
AZ Shah ,Fiji,2024,2024,2,2,0,0,0,0,0,0
Shahadat Hossain ,BAN,2006,2013,6,6,0,0,0,0,0,0
Shahadat Hossain (3) ,BAN,2023,2023,3,3,0,0,0,0,0,0
Shohidul Islam ,BAN,2021,2021,1,1,0,0,0,0,0,0
Shahid Ahmadzai ,Canada,2023,2023,1,1,0,0,0,0,0,0
Shahrukh Quddus ,KUW,2022,2024,11,11,0,0,0,0,0,0
Shahzad Muhammad ,Mex,2019,2019,2,2,0,0,0,0,0,0
Shahzaib ,KSA,2024,2024,5,5,0,0,0,0,0,0
Shakerullah Safi ,DEN,2021,2021,4,4,0,0,0,0,0,0
T Shanmugam ,SEY,2022,2022,6,5,0,0,0,0,0,0
Shan Siddiqui ,GMB,2024,2024,2,2,0,0,0,0,0,0
Sharif Asadullah ,United Arab Emirates,2014,2014,1,1,0,0,0,0,0,0
KV Sharma ,India,2014,2014,1,1,0,0,0,0,0,0
R Sharma ,India,2012,2012,2,2,0,0,0,0,0,0
SM Sharma ,United Arab Emirates,2021,2023,4,4,0,0,0,0,0,0
Sharveen Surendran ,MAS,2023,2023,2,2,0,0,0,0,0,0
ZK Shem ,VAN,2019,2019,5,5,0,0,0,0,0,0
Shenjian Zheng ,CHN,2024,2024,4,4,0,0,0,0,0,0
DK Shetty ,INA,2023,2024,5,5,0,0,0,0,0,0
SG Shinde ,SRB,2022,2022,1,1,0,0,0,0,0,0
HB Shipley ,New Zealand,2023,2023,5,4,0,0,0,0,0,0
K Shivam ,CRC,2024,2024,2,2,0,0,0,0,0,0
Shoaib Gazi Hossain ,Chile,2019,2019,4,4,0,0,0,0,0,0
Shoaib Khan ,GER,2022,2022,6,6,0,0,0,0,0,0
PK Shoufeer ,CAM,2023,2023,6,5,0,0,0,0,0,0
LK Sharma ,Mex,2024,2024,1,1,0,0,0,0,0,0
A Shukla ,CRT,2024,2024,5,5,0,0,0,0,0,0
Z Shurentsetseg ,MNG,2024,2024,12,12,0,0,0,0,0,0
P Sibiya ,SWZ,2022,2022,1,1,0,0,0,0,0,0
MM Siddique ,Japan,2023,2024,3,3,0,0,0,0,0,0
PM Siddle ,Australia,2009,2010,2,2,0,0,0,0,0,0
M Sidibe ,Mali,2022,2022,3,3,0,0,0,0,0,0
Sikander Billah ,BHR,2022,2022,7,7,0,0,0,0,0,0
KM Silva ,BRA,2019,2019,3,3,0,0,0,0,0,0
IC Simao ,BRA,2024,2024,1,1,0,0,0,0,0,0
M Simmons ,BER,2019,2021,6,6,0,0,0,0,0,0
D Simpson ,COK,2022,2022,3,3,0,0,0,0,0,0
S Simpson ,JER,2024,2024,2,2,0,0,0,0,0,0
Z Simpson ,GIBR,2022,2022,2,2,0,0,0,0,0,0
Simranjit Singh ,ITA,2019,2019,1,1,0,0,0,0,0,0
Sinan Khan ,GRC,2024,2024,4,4,0,0,0,0,0,0
MS Sinclair ,New Zealand,2005,2007,2,2,0,0,0,0,0,0
S Singh ,PHI,2019,2023,5,5,0,0,0,0,0,0
S Singh ,PORT,2019,2019,1,1,0,0,0,0,0,0
JR Singleton ,BRA,2019,2019,3,3,0,0,0,0,0,0
T Singye ,BHU,2019,2019,2,2,0,0,0,0,0,0
D Siva Kumar ,United States of America,2022,2022,1,1,0,0,0,0,0,0
GH Smit ,GUE,2023,2023,3,3,0,0,0,0,0,0
G Smith ,CAY,2022,2022,3,3,0,0,0,0,0,0
NJA Smith ,PHI,2023,2023,3,3,0,0,0,0,0,0
RAJ Smith ,Scotland,2019,2019,2,2,0,0,0,0,0,0
Sohail Khan ,Pakistan,2008,2017,5,5,0,0,0,0,0,0
S Sohal ,United States of America,2019,2019,3,3,0,0,0,0,0,0
Soheel Hussain ,Belg,2019,2019,1,1,0,0,0,0,0,0
Sohrawordi Shuvo ,BAN,2010,2010,1,1,0,0,0,0,0,0
S Soosiyakumar ,BUL,2019,2019,1,1,0,0,0,0,0,0
U Sorovakatini ,Fiji,2023,2023,1,1,0,0,0,0,0,0
ES Soto ,CRC,2019,2019,1,1,0,0,0,0,0,0
SK Springer ,West Indies,2024,2024,2,2,0,0,0,0,0,0
M Spry ,Peru,2019,2019,4,4,0,0,0,0,0,0
BB Sran ,India,2016,2016,2,2,0,0,0,0,0,0
L Sreekumar ,United Arab Emirates,2017,2017,1,1,0,0,0,0,0,0
U Srivastava ,United States of America,2024,2024,2,2,0,0,0,0,0,0
AJ Staal ,NED,2019,2021,14,14,0,0,0,0,0,0
B Stanlake ,Australia,2017,2019,19,19,0,0,0,0,0,0
BS Stephenson ,Blz,2019,2021,9,9,0,0,0,0,0,0
TJ Stephenson ,Blz,2019,2021,4,4,0,0,0,0,0,0
M Stoman ,PORT,2021,2021,3,3,0,0,0,0,0,0
OP Stone ,England,2022,2022,1,1,0,0,0,0,0,0
BK Stroud ,STHEL,2022,2024,8,7,0,0,0,0,0,0
O Stewart ,Bhm,2021,2021,5,5,0,0,0,0,0,0
L Stubbs ,CRT,2023,2023,4,3,0,0,0,0,0,0
GA Stuurman ,South Africa,2021,2021,1,1,0,0,0,0,0,0
P Sua ,Samoa,2024,2024,2,2,0,0,0,0,0,0
K Subramanian ,SGP,2020,2020,1,1,0,0,0,0,0,0
Suhail Sadiq ,LUX,2019,2019,2,2,0,0,0,0,0,0
Suhrid Roy ,MLT,2019,2021,2,2,0,0,0,0,0,0
J Suleman ,SWZ,2024,2024,1,1,0,0,0,0,0,0
Sumair Khan ,MLT,2019,2019,1,1,0,0,0,0,0,0
Sumon Khan ,BAN,2023,2023,1,1,0,0,0,0,0,0
Suresh Kumar ,Peru,2019,2019,2,2,0,0,0,0,0,0
ZE Surkari ,Canada,2008,2008,4,4,0,0,0,0,0,0
M Swack ,CAY,2022,2022,4,4,0,0,0,0,0,0
R Swart ,BOT,2023,2023,4,4,0,0,0,0,0,0
Shayan Khan ,EST,2024,2024,1,1,0,0,0,0,0,0
Syed Aqeel Israr ,GHA,2023,2024,10,10,0,0,0,0,0,0
Syed Amanullah ,GRC,2021,2021,4,4,0,0,0,0,0,0
Syed Hussain ,CYP,2022,2022,1,1,0,0,0,0,0,0
Taijul Islam ,BAN,2019,2019,2,2,0,0,0,0,0,0
T Takada ,Japan,2023,2023,3,3,0,0,0,0,0,0
R Tanna ,EST,2022,2022,1,1,0,0,0,0,0,0
Tanvir Ahmed ,Pakistan,2010,2010,1,1,0,0,0,0,0,0
S Tarawally ,Sri LankaE,2021,2021,6,6,0,0,0,0,0,0
K Tari ,VAN,2024,2024,1,1,0,0,0,0,0,0
Tariq Aziz ,PORT,2019,2019,4,4,0,0,0,0,0,0
Tarun Yadav ,BUL,2022,2022,3,3,0,0,0,0,0,0
Tasaduq Hussain ,SWE,2022,2022,3,3,0,0,0,0,0,0
Tashi Dorji ,BHU,2024,2024,1,1,0,0,0,0,0,0
EG Taylor ,Chile,2023,2023,2,2,0,0,0,0,0,0
R Telemachus ,South Africa,2006,2007,3,3,0,0,0,0,0,0
B Terbish ,MNG,2023,2024,4,4,0,0,0,0,0,0
Te Senglong ,CAM,2023,2023,2,2,0,0,0,0,0,0
N Thailappan ,BHR,2022,2022,2,2,0,0,0,0,0,0
S Thakur ,ROM,2021,2023,6,6,0,0,0,0,0,0
R Thapliyal ,Belg,2023,2024,6,6,0,0,0,0,0,0
R Theruvath ,QAT,2024,2024,2,2,0,0,0,0,0,0
J Thinley ,BHU,2019,2019,2,2,0,0,0,0,0,0
Tholal Mohamed Raya ,MDV,2023,2023,2,2,0,0,0,0,0,0
AC Thomas ,South Africa,2007,2007,1,1,0,0,0,0,0,0
J Thomas ,STHEL,2024,2024,1,1,0,0,0,0,0,0
EP Thompson ,New Zealand,2008,2008,1,1,0,0,0,0,0,0
P Thongsa ,THA,2022,2022,2,2,0,0,0,0,0,0
F Thorpe ,GMB,2022,2022,2,2,0,0,0,0,0,0
S Thuraisingam ,Canada,2008,2008,3,3,0,0,0,0,0,0
N Thushara ,Sri Lanka,2022,2024,15,15,0,0,0,0,0,0
Tian Sen Qun ,CHN,2023,2024,11,11,0,0,0,0,0,0
KK Tillett ,Blz,2021,2021,5,5,0,0,0,0,0,0
OSB Tilley ,CRT,2024,2024,1,1,0,0,0,0,0,0
S Toutai ,Samoa,2023,2023,3,3,0,0,0,0,0,0
CT Tremlett ,England,2007,2007,1,1,0,0,0,0,0,0
D Tresac ,SRB,2023,2023,1,1,0,0,0,0,0,0
A Trivedi ,LUX,2022,2022,1,1,0,0,0,0,0,0
IJL Trott ,England,2007,2010,7,7,0,0,0,0,0,0
CK Tshuma ,Zimbabwe,2020,2020,1,1,0,0,0,0,0,0
TE Tucker ,BER,2008,2008,1,1,0,0,0,0,0,0
DR Tuffey ,New Zealand,2005,2010,3,3,0,0,0,0,0,0
J Tuffin ,PHI,2024,2024,7,7,0,0,0,0,0,0
M Tuilaepa ,Samoa,2023,2023,2,2,0,0,0,0,0,0
S Tuitoga ,Fiji,2023,2023,2,2,0,0,0,0,0,0
SM Tupou ,Fiji,2022,2023,9,9,0,0,0,0,0,0
T Turan ,TKY,2019,2024,7,7,0,0,0,0,0,0
JA Turner ,England,2024,2024,2,2,0,0,0,0,0,0
N Tyagi ,CZK-R,2023,2024,2,2,0,0,0,0,0,0
S Udawaththa ,United Arab Emirates,2023,2023,1,1,0,0,0,0,0,0
ML Udawatte ,Sri Lanka,2008,2017,8,8,0,0,0,0,0,0
T Ulutuna ,TKY,2019,2022,6,6,0,0,0,0,0,0
Umair Ali ,United Arab Emirates,2015,2015,3,3,0,0,0,0,0,0
J Umanath ,Mex,2019,2019,7,7,0,0,0,0,0,0
Usman Mushtaq ,United Arab Emirates,2016,2016,3,3,0,0,0,0,0,0
Usman Rafiq ,United States of America,2024,2024,1,1,0,0,0,0,0,0
WPUJC Vaas ,Sri Lanka,2006,2007,6,6,0,0,0,0,0,0
VL Mukesh ,SEY,2021,2022,8,7,0,0,0,0,0,0
SD Valjalo ,CRT,2022,2022,5,5,0,0,0,0,0,0
AC Valthapa ,United Arab Emirates,2024,2024,1,1,0,0,0,0,0,0
JJ van der Wath ,South Africa,2006,2007,8,8,0,0,0,0,0,0
VB van Jaarsveld ,South Africa,2009,2009,3,3,0,0,0,0,0,0
TF van Woerkom ,Ireland,2023,2023,1,1,0,0,0,0,0,0
E Van Reenen ,SRB,2024,2024,3,3,0,0,0,0,0,0
S Varathappan ,KUW,2019,2019,3,3,0,0,0,0,0,0
S Vats ,LUX,2020,2021,5,5,0,0,0,0,0,0
MP Vaughan ,England,2005,2007,2,2,0,0,0,0,0,0
VN Veetil ,QAT,2022,2022,7,7,0,0,0,0,0,0
KM Venkataswamy ,CZK-R,2022,2022,1,1,0,0,0,0,0,0
DJ Vilas ,South Africa,2012,2012,1,1,0,0,0,0,0,0
N Vimukthi ,Sri Lanka,2023,2023,1,1,0,0,0,0,0,0
TC Vine ,ESP,2019,2022,11,11,0,0,0,0,0,0
RV Viraj ,CAM,2024,2024,4,4,0,0,0,0,0,0
Virendra Kumar ,ISR,2024,2024,4,4,0,0,0,0,0,0
R Vishwanath ,LUX,2019,2023,6,6,0,0,0,0,0,0
RL Vitas ,SRB,2022,2022,9,9,0,0,0,0,0,0
V Viyaskanth ,Sri Lanka,2023,2023,1,1,0,0,0,0,0,0
C Vorster ,GUE,2019,2019,1,1,0,0,0,0,0,0
Wafadar Momand ,Afghanistan,2023,2024,2,2,0,0,0,0,0,0
SB Wagh ,Mex,2024,2024,5,5,0,0,0,0,0,0
Waleed Rana ,ITA,2022,2022,3,3,0,0,0,0,0,0
E Walker ,IOM,2023,2023,5,5,0,0,0,0,0,0
M Walker ,BER,2023,2023,1,1,0,0,0,0,0,0
FN Walsh ,PHI,2023,2023,1,1,0,0,0,0,0,0
T Wangchuk jnr ,BHU,2019,2019,2,2,0,0,0,0,0,0
Wang Qi ,CHN,2023,2023,4,4,0,0,0,0,0,0
Wan Azam ,MAS,2023,2023,1,1,0,0,0,0,0,0
Waqar Ali ,CYP,2021,2021,4,4,0,0,0,0,0,0
Waqas Maqsood ,Pakistan,2018,2018,1,1,0,0,0,0,0,0
Waqas Raja ,FIN,2019,2019,1,1,0,0,0,0,0,0
I Wardlaw ,Scotland,2013,2013,4,4,0,0,0,0,0,0
Wasim Ali ,OMA,2019,2024,4,4,0,0,0,0,0,0
NR Welch ,Zimbabwe,2023,2023,7,7,0,0,0,0,0,0
UWMBCA Welegedara ,Sri Lanka,2010,2010,2,2,0,0,0,0,0,0
B Wentzel ,GUE,2022,2022,1,1,0,0,0,0,0,0
SG Whittingham ,Scotland,2018,2018,3,3,0,0,0,0,0,0
G Wijekoon ,Sri Lanka,2007,2007,3,3,0,0,0,0,0,0
KY Wilfried ,CIV,2024,2024,1,1,0,0,0,0,0,0
MB Williams ,Sri LankaE,2023,2023,3,3,0,0,0,0,0,0
JW Wilson ,New Zealand,2005,2005,1,1,0,0,0,0,0,0
DGAPD Wiswi ,INA,2024,2024,4,4,0,0,0,0,0,0
T Wuatai ,COK,2024,2024,1,1,0,0,0,0,0,0
Xie Kunkun ,CHN,2023,2023,4,4,0,0,0,0,0,0
Xie Qiulai ,CHN,2024,2024,1,1,0,0,0,0,0,0
MP Yadav ,India,2024,2024,3,3,0,0,0,0,0,0
ST Yalimaiwai ,Fiji,2024,2024,3,3,0,0,0,0,0,0
Yamin Ahmadzai ,Afghanistan,2015,2015,2,2,0,0,0,0,0,0
Yash Talati ,Kenya,2022,2022,2,2,0,0,0,0,0,0
Yasser Nazir ,BHR,2023,2023,2,2,0,0,0,0,0,0
Yin Chenhao ,CHN,2023,2023,3,3,0,0,0,0,0,0
Yogev Nagavkar ,ISR,2022,2024,5,5,0,0,0,0,0,0
A Yon ,STHEL,2022,2024,8,7,0,0,0,0,0,0
N Yordanov ,BUL,2019,2019,2,2,0,0,0,0,0,0
D Young ,STHEL,2024,2024,1,1,0,0,0,0,0,0
Yousef Shadzehisarjou ,Iran,2020,2020,3,3,0,0,0,0,0,0
Yousuf Ali ,QAT,2022,2023,4,4,0,0,0,0,0,0
Yousif Wali ,BHR,2022,2023,2,1,0,0,0,0,0,0
Zabiullah Ibrahimkhel ,Aut,2021,2021,1,1,0,0,0,0,0,0
Zabiullah Zahid ,SWE,2023,2024,2,2,0,0,0,0,0,0
Zafer Durmaz ,TKY,2022,2024,4,4,0,0,0,0,0,0
Zahid Mahmood ,Pakistan,2021,2021,1,1,0,0,0,0,0,0
Zahir Khan ,Afghanistan,2023,2023,4,3,0,0,0,0,0,0
Zain ul Tashnam ,CRC,2019,2019,3,3,0,0,0,0,0,0
Zamir Khan ,Afghanistan,2012,2012,1,1,0,0,0,0,0,0
S Zargar ,Mex,2019,2019,1,1,0,0,0,0,0,0
Zeerak Chughtai ,BUL,2023,2024,8,8,0,0,0,0,0,0
Zeeshan Sarwar ,CYP,2021,2021,4,4,0,0,0,0,0,0
Zeeshan Siddiqui ,OMA,2015,2015,5,5,0,0,0,0,0,0
Ziaur Rahman ,Afghanistan,2019,2019,1,1,0,0,0,0,0,0
M Zondeki ,South Africa,2006,2006,1,1,0,0,0,0,0,0
Zuhair Muhammad ,KSA,2024,2024,2,2,0,0,0,0,0,0
Zulfiqar Ali Shah ,PORT,2021,2021,1,1,0,0,0,0,0,0
GMC Mol ,NED,2008,2008,1,NA,NA,NA,NA,NA,NA,NA
JD Schoonheim ,NED,2008,2008,1,NA,NA,NA,NA,NA,NA,NA
Zubaid Akbari ,Afghanistan,2023,2023,1,NA,NA,NA,NA,NA,NA,NA
